
Runde , StartKonto , EndKonto , Einsatz , Farbe , CasinoKonto, Gewonnen , Kugel , Gewinn/Verlust , LVL , EXP , expAnzahl, Multi , expBonus
1,1000,999,1,ROT,1001,0,15,1,0,0.000000,0.010000,0.010000,0.000000
2,999,1001,2,SCHWARZ,999,1,10,2,0,0.010000,0.048048,0.020020,0.004004
3,1001,1002,1,SCHWARZ,998,1,33,3,0,0.058048,0.011988,0.009990,0.001998
4,1002,1003,1,SCHWARZ,997,1,10,4,0,0.070036,0.011976,0.009980,0.001996
5,1003,1004,1,SCHWARZ,996,1,26,5,0,0.082012,0.011964,0.009970,0.001994
6,1004,1003,1,SCHWARZ,997,0,3,1,0,0.093976,0.009960,0.009960,0.001994
7,1003,1005,2,ROT,995,1,9,2,0,0.103936,0.047856,0.019940,0.003988
8,1005,1004,1,ROT,996,0,17,2,0,0.151793,0.009950,0.009950,0.003988
9,1004,1006,2,SCHWARZ,994,1,33,7,0,0.161743,0.047809,0.019920,0.003984
10,1006,1007,1,SCHWARZ,993,1,28,8,0,0.209552,0.011928,0.009940,0.001988
11,1007,1008,1,SCHWARZ,992,1,24,9,0,0.221480,0.011917,0.009930,0.001986
12,1008,1007,1,SCHWARZ,993,0,23,2,0,0.233397,0.009921,0.009921,0.001986
13,1007,1005,2,ROT,995,0,29,4,0,0.243317,0.039722,0.019861,0.001986
14,1005,1009,4,SCHWARZ,991,1,2,13,0,0.283039,0.191045,0.039801,0.007960
15,1009,1010,1,SCHWARZ,990,1,31,14,0,0.474084,0.011893,0.009911,0.001982
16,1010,1009,1,SCHWARZ,991,0,27,3,0,0.485977,0.009901,0.009901,0.001982
17,1009,1011,2,ROT,989,1,3,4,0,0.495878,0.047572,0.019822,0.003964
18,1011,1012,1,ROT,988,1,19,5,0,0.543450,0.011869,0.009891,0.001978
19,1012,1013,1,ROT,987,1,25,6,0,0.555319,0.011858,0.009881,0.001976
20,1013,1014,1,ROT,986,1,23,7,0,0.567177,0.011846,0.009872,0.001974
21,1014,1015,1,ROT,985,1,32,8,0,0.579023,0.011834,0.009862,0.001972
22,1015,1016,1,ROT,984,1,9,9,0,0.590857,0.011823,0.009852,0.001970
23,1016,1015,1,ROT,985,0,15,5,0,0.602680,0.009843,0.009843,0.001970
24,1015,1013,2,SCHWARZ,987,0,21,5,0,0.612523,0.039409,0.019704,0.001970
25,1013,1009,4,ROT,991,0,26,9,0,0.651932,0.157947,0.039487,0.001970
26,1009,1017,8,SCHWARZ,983,1,4,22,0,0.809878,0.761150,0.079286,0.015857
27,1017,1018,1,SCHWARZ,982,1,33,23,0,1.571028,0.011799,0.009833,0.001967
28,1018,1019,1,SCHWARZ,981,1,22,24,0,1.582827,0.011788,0.009823,0.001965
29,1019,1020,1,SCHWARZ,980,1,29,25,0,1.594615,0.011776,0.009814,0.001963
30,1020,1019,1,SCHWARZ,981,0,30,6,0,1.606391,0.009804,0.009804,0.001963
31,1019,1021,2,ROT,979,1,7,11,0,1.616195,0.047105,0.019627,0.003925
32,1021,1020,1,ROT,980,0,24,10,0,1.663300,0.009794,0.009794,0.003925
33,1020,1018,2,SCHWARZ,982,0,18,8,0,1.673095,0.039216,0.019608,0.003925
34,1018,1014,4,ROT,986,0,11,14,0,1.712310,0.157171,0.039293,0.003925
35,1014,1006,8,SCHWARZ,994,0,3,16,0,1.869481,0.631164,0.078895,0.003925
36,1006,990,16,ROT,1010,0,15,30,0,2.500645,2.544732,0.159046,0.003925
37,990,958,32,SCHWARZ,1042,0,32,48,0,5.045377,10.343434,0.323232,0.003925
38,958,1022,64,ROT,978,1,3,75,0,15.388811,51.306889,0.668058,0.133612
39,1022,1023,1,ROT,977,1,7,76,0,66.695700,0.011742,0.009785,0.001957
40,1023,1024,1,ROT,976,1,30,77,0,66.707442,0.011730,0.009775,0.001955
41,1024,1023,1,ROT,977,0,15,31,0,66.719172,0.009766,0.009766,0.001955
42,1023,1025,2,SCHWARZ,975,1,26,27,0,66.728938,0.046921,0.019550,0.003910
43,1025,1026,1,SCHWARZ,974,1,35,28,0,66.775859,0.011707,0.009756,0.001951
44,1026,1025,1,SCHWARZ,975,0,18,49,0,66.787566,0.009747,0.009747,0.001951
45,1025,1023,2,ROT,977,0,29,33,0,66.797313,0.039024,0.019512,0.001951
46,1023,1019,4,SCHWARZ,981,0,36,53,0,66.836337,0.156403,0.039101,0.001951
47,1019,1027,8,ROT,973,1,7,85,0,66.992740,0.753680,0.078508,0.015702
48,1027,1028,1,ROT,972,1,25,86,0,67.746420,0.011685,0.009737,0.001947
49,1028,1027,1,ROT,973,0,8,34,0,67.758104,0.009728,0.009728,0.001947
50,1027,1025,2,SCHWARZ,975,0,32,55,0,67.767832,0.038948,0.019474,0.001947
51,1025,1029,4,ROT,971,1,27,90,0,67.806780,0.187317,0.039024,0.007805
52,1029,1028,1,ROT,972,0,33,35,0,67.994097,0.009718,0.009718,0.007805
53,1028,1030,2,SCHWARZ,970,1,29,30,0,68.003816,0.046693,0.019455,0.003891
54,1030,1029,1,SCHWARZ,971,0,0,56,0,68.050508,0.009709,0.009709,0.003891
55,1029,1027,2,ROT,973,0,4,37,0,68.060217,0.038873,0.019436,0.003891
56,1027,1031,4,SCHWARZ,969,1,22,34,0,68.099090,0.186952,0.038948,0.007790
57,1031,1030,1,SCHWARZ,970,0,9,57,0,68.286042,0.009699,0.009699,0.007790
58,1030,1028,2,ROT,972,0,31,39,0,68.295741,0.038835,0.019417,0.007790
59,1028,1032,4,SCHWARZ,968,1,31,38,0,68.334576,0.186770,0.038911,0.007782
60,1032,1031,1,SCHWARZ,969,0,27,58,0,68.521347,0.009690,0.009690,0.007782
61,1031,1029,2,ROT,971,0,2,41,0,68.531037,0.038797,0.019399,0.007782
62,1029,1033,4,SCHWARZ,967,1,29,42,0,68.569834,0.186589,0.038873,0.007775
63,1033,1032,1,SCHWARZ,968,0,16,59,0,68.756423,0.009681,0.009681,0.007775
64,1032,1030,2,ROT,970,0,31,43,0,68.766103,0.038760,0.019380,0.007775
65,1030,1034,4,SCHWARZ,966,1,26,46,0,68.804863,0.186408,0.038835,0.007767
66,1034,1033,1,SCHWARZ,967,0,36,60,0,68.991271,0.009671,0.009671,0.007767
67,1033,1031,2,ROT,969,0,31,45,0,69.000942,0.038722,0.019361,0.007767
68,1031,1035,4,SCHWARZ,965,1,20,50,0,69.039664,0.186227,0.038797,0.007759
69,1035,1034,1,SCHWARZ,966,0,32,61,0,69.225891,0.009662,0.009662,0.007759
70,1034,1036,2,ROT,964,1,19,92,0,69.235553,0.046422,0.019342,0.003868
71,1036,1035,1,ROT,965,0,13,46,0,69.281975,0.009653,0.009653,0.003868
72,1035,1033,2,SCHWARZ,967,0,19,63,0,69.291627,0.038647,0.019324,0.003868
73,1033,1037,4,ROT,963,1,14,96,0,69.330274,0.185866,0.038722,0.007744
74,1037,1036,1,ROT,964,0,20,47,0,69.516141,0.009643,0.009643,0.007744
75,1036,1034,2,SCHWARZ,966,0,34,65,0,69.525784,0.038610,0.019305,0.007744
76,1034,1038,4,ROT,962,1,12,100,0,69.564394,0.185687,0.038685,0.007737
77,1038,1039,1,ROT,961,1,34,101,0,69.750081,0.011561,0.009634,0.001927
78,1039,1040,1,ROT,960,1,25,102,0,69.761641,0.011550,0.009625,0.001925
79,1040,1039,1,ROT,961,0,29,48,0,69.773191,0.009615,0.009615,0.001925
80,1039,1041,2,SCHWARZ,959,1,35,52,0,69.782806,0.046198,0.019249,0.003850
81,1041,1042,1,SCHWARZ,958,1,33,53,0,69.829005,0.011527,0.009606,0.001921
82,1042,1043,1,SCHWARZ,957,1,17,54,0,69.840532,0.011516,0.009597,0.001919
83,1043,1044,1,SCHWARZ,956,1,24,55,0,69.852048,0.011505,0.009588,0.001918
84,1044,1043,1,SCHWARZ,957,0,23,66,0,69.863554,0.009579,0.009579,0.001918
85,1043,1041,2,ROT,959,0,31,50,0,69.873132,0.038351,0.019175,0.001918
86,1041,1037,4,SCHWARZ,963,0,14,70,0,69.911483,0.153698,0.038425,0.001918
87,1037,1045,8,ROT,955,1,14,110,0,70.065181,0.740598,0.077146,0.015429
88,1045,1046,1,ROT,954,1,12,111,0,70.805779,0.011483,0.009569,0.001914
89,1046,1047,1,ROT,953,1,36,112,0,70.817263,0.011472,0.009560,0.001912
90,1047,1046,1,ROT,954,0,20,51,0,70.828735,0.009551,0.009551,0.001912
91,1046,1048,2,SCHWARZ,952,1,29,57,0,70.838286,0.045889,0.019120,0.003824
92,1048,1047,1,SCHWARZ,953,0,5,71,0,70.884175,0.009542,0.009542,0.003824
93,1047,1049,2,ROT,951,1,19,114,0,70.893717,0.045845,0.019102,0.003820
94,1049,1050,1,ROT,950,1,7,115,0,70.939562,0.011439,0.009533,0.001907
95,1050,1049,1,ROT,951,0,11,52,0,70.951002,0.009524,0.009524,0.001907
96,1049,1051,2,SCHWARZ,949,1,33,59,0,70.960526,0.045758,0.019066,0.003813
97,1051,1052,1,SCHWARZ,948,1,4,60,0,71.006283,0.011418,0.009515,0.001903
98,1052,1051,1,SCHWARZ,949,0,30,72,0,71.017701,0.009506,0.009506,0.001903
99,1051,1053,2,ROT,947,1,27,117,0,71.027207,0.045671,0.019029,0.003806
100,1053,1054,1,ROT,946,1,36,118,0,71.072878,0.011396,0.009497,0.001899
101,1054,1055,1,ROT,945,1,23,119,0,71.084274,0.011385,0.009488,0.001898
102,1055,1054,1,ROT,946,0,31,53,0,71.095659,0.009479,0.009479,0.001898
103,1054,1052,2,SCHWARZ,948,0,27,74,0,71.105137,0.037951,0.018975,0.001898
104,1052,1048,4,ROT,952,0,20,57,0,71.143088,0.152091,0.038023,0.001898
105,1048,1040,8,SCHWARZ,960,0,32,82,0,71.295179,0.610687,0.076336,0.001898
106,1040,1056,16,ROT,944,1,12,135,0,71.905866,2.953846,0.153846,0.030769
107,1056,1055,1,ROT,945,0,31,58,0,74.859713,0.009470,0.009470,0.030769
108,1055,1053,2,SCHWARZ,947,0,0,84,0,74.869182,0.037915,0.018957,0.030769
109,1053,1057,4,ROT,943,1,27,139,0,74.907097,0.182336,0.037987,0.007597
110,1057,1058,1,ROT,942,1,30,140,0,75.089433,0.011353,0.009461,0.001892
111,1058,1057,1,ROT,943,0,4,59,0,75.100786,0.009452,0.009452,0.001892
112,1057,1059,2,SCHWARZ,941,1,29,62,0,75.110238,0.045412,0.018921,0.003784
113,1059,1058,1,SCHWARZ,942,0,14,85,0,75.155649,0.009443,0.009443,0.003784
114,1058,1056,2,ROT,944,0,0,61,0,75.165092,0.037807,0.018904,0.003784
115,1056,1052,4,SCHWARZ,948,0,25,89,0,75.202899,0.151515,0.037879,0.003784
116,1052,1044,8,ROT,956,0,11,69,0,75.354415,0.608365,0.076046,0.003784
117,1044,1028,16,SCHWARZ,972,0,34,105,0,75.962780,2.452107,0.153257,0.003784
118,1028,996,32,ROT,1004,0,8,101,0,78.414887,9.961089,0.311284,0.003784
119,996,932,64,SCHWARZ,1068,0,1,169,0,88.375976,41.124498,0.642570,0.003784
120,932,931,1,ROT,1069,0,24,102,0,129.500474,0.010730,0.010730,0.003784
121,931,933,2,SCHWARZ,1067,1,13,64,0,129.511204,0.051557,0.021482,0.004296
122,933,932,1,SCHWARZ,1068,0,0,170,0,129.562761,0.010718,0.010718,0.004296
123,932,930,2,ROT,1070,0,31,104,0,129.573480,0.042918,0.021459,0.004296
124,930,934,4,SCHWARZ,1066,1,6,68,0,129.616398,0.206452,0.043011,0.008602
125,934,933,1,SCHWARZ,1067,0,18,171,0,129.822850,0.010707,0.010707,0.008602
126,933,935,2,ROT,1065,1,5,142,0,129.833556,0.051447,0.021436,0.004287
127,935,936,1,ROT,1064,1,3,143,0,129.885003,0.012834,0.010695,0.002139
128,936,937,1,ROT,1063,1,25,144,0,129.897837,0.012821,0.010684,0.002137
129,937,938,1,ROT,1062,1,19,145,0,129.910658,0.012807,0.010672,0.002134
130,938,939,1,ROT,1061,1,30,146,0,129.923465,0.012793,0.010661,0.002132
131,939,940,1,ROT,1060,1,18,147,0,129.936258,0.012780,0.010650,0.002130
132,940,941,1,ROT,1059,1,34,148,0,129.949038,0.012766,0.010638,0.002128
133,941,940,1,ROT,1060,0,28,105,0,129.961803,0.010627,0.010627,0.002128
134,940,938,2,SCHWARZ,1062,0,25,173,0,129.972430,0.042553,0.021277,0.002128
135,938,942,4,ROT,1058,1,12,152,0,130.014984,0.204691,0.042644,0.008529
136,942,941,1,ROT,1059,0,13,106,0,130.219674,0.010616,0.010616,0.008529
137,941,939,2,SCHWARZ,1061,0,21,175,0,130.230290,0.042508,0.021254,0.008529
138,939,935,4,ROT,1065,0,28,110,0,130.272798,0.170394,0.042599,0.008529
139,935,927,8,SCHWARZ,1073,0,36,183,0,130.443192,0.684492,0.085561,0.008529
140,927,911,16,ROT,1089,0,8,126,0,131.127684,2.761597,0.172600,0.008529
141,911,879,32,SCHWARZ,1121,0,30,215,0,133.889281,11.240395,0.351262,0.008529
142,879,943,64,ROT,1057,1,21,216,0,145.129676,55.918089,0.728100,0.145620
143,943,942,1,ROT,1058,0,13,127,0,201.047765,0.010604,0.010604,0.145620
144,942,940,2,SCHWARZ,1060,0,9,217,0,201.058369,0.042463,0.021231,0.145620
145,940,944,4,ROT,1056,1,23,220,0,201.100832,0.204255,0.042553,0.008511
146,944,943,1,ROT,1057,0,28,128,0,201.305087,0.010593,0.010593,0.008511
147,943,945,2,SCHWARZ,1055,1,4,70,0,201.315681,0.050901,0.021209,0.004242
148,945,944,1,SCHWARZ,1056,0,3,218,0,201.366582,0.010582,0.010582,0.004242
149,944,946,2,ROT,1054,1,30,222,0,201.377164,0.050847,0.021186,0.004237
150,946,945,1,ROT,1055,0,6,129,0,201.428011,0.010571,0.010571,0.004237
151,945,947,2,SCHWARZ,1053,1,10,72,0,201.438582,0.050794,0.021164,0.004233
152,947,948,1,SCHWARZ,1052,1,6,73,0,201.489376,0.012672,0.010560,0.002112
153,948,949,1,SCHWARZ,1051,1,24,74,0,201.502048,0.012658,0.010549,0.002110
154,949,948,1,SCHWARZ,1052,0,23,219,0,201.514706,0.010537,0.010537,0.002110
155,948,950,2,ROT,1050,1,21,224,0,201.525243,0.050633,0.021097,0.004219
156,950,951,1,ROT,1049,1,9,225,0,201.575876,0.012632,0.010526,0.002105
157,951,952,1,ROT,1048,1,3,226,0,201.588508,0.012618,0.010515,0.002103
158,952,953,1,ROT,1047,1,14,227,0,201.601126,0.012605,0.010504,0.002101
159,953,952,1,ROT,1048,0,35,130,0,201.613731,0.010493,0.010493,0.002101
160,952,950,2,SCHWARZ,1050,0,34,221,0,201.624224,0.042017,0.021008,0.002101
161,950,946,4,ROT,1054,0,11,134,0,201.666241,0.168421,0.042105,0.002101
162,946,954,8,SCHWARZ,1046,1,20,82,0,201.834662,0.811839,0.084567,0.016913
163,954,953,1,SCHWARZ,1047,0,0,222,0,202.646501,0.010482,0.010482,0.016913
164,953,951,2,ROT,1049,0,4,136,0,202.656984,0.041973,0.020986,0.016913
165,951,947,4,SCHWARZ,1053,0,1,226,0,202.698956,0.168244,0.042061,0.016913
166,947,939,8,ROT,1061,0,10,144,0,202.867200,0.675818,0.084477,0.016913
167,939,955,16,SCHWARZ,1045,1,28,98,0,203.543019,3.271566,0.170394,0.034079
168,955,954,1,SCHWARZ,1046,0,12,227,0,206.814584,0.010471,0.010471,0.034079
169,954,952,2,ROT,1048,0,20,146,0,206.825055,0.041929,0.020964,0.034079
170,952,956,4,SCHWARZ,1044,1,2,102,0,206.866984,0.201681,0.042017,0.008403
171,956,955,1,SCHWARZ,1045,0,30,228,0,207.068665,0.010460,0.010460,0.008403
172,955,953,2,ROT,1047,0,13,148,0,207.079125,0.041885,0.020942,0.008403
173,953,957,4,SCHWARZ,1043,1,20,106,0,207.121010,0.201469,0.041973,0.008395
174,957,958,1,SCHWARZ,1042,1,17,107,0,207.322479,0.012539,0.010449,0.002090
175,958,959,1,SCHWARZ,1041,1,13,108,0,207.335018,0.012526,0.010438,0.002088
176,959,960,1,SCHWARZ,1040,1,31,109,0,207.347544,0.012513,0.010428,0.002086
177,960,959,1,SCHWARZ,1041,0,21,229,0,207.360057,0.010417,0.010417,0.002086
178,959,957,2,ROT,1043,0,26,150,0,207.370474,0.041710,0.020855,0.002086
179,957,953,4,SCHWARZ,1047,0,12,233,0,207.412184,0.167189,0.041797,0.002086
180,953,961,8,ROT,1039,1,30,235,0,207.579373,0.805876,0.083945,0.016789
181,961,962,1,ROT,1038,1,14,236,0,208.385249,0.012487,0.010406,0.002081
182,962,963,1,ROT,1037,1,32,237,0,208.397736,0.012474,0.010395,0.002079
183,963,964,1,ROT,1036,1,9,238,0,208.410210,0.012461,0.010384,0.002077
184,964,963,1,ROT,1037,0,0,151,0,208.422671,0.010373,0.010373,0.002077
185,963,961,2,SCHWARZ,1039,0,16,235,0,208.433045,0.041537,0.020768,0.002077
186,961,965,4,ROT,1035,1,32,242,0,208.474582,0.199792,0.041623,0.008325
187,965,966,1,ROT,1034,1,9,243,0,208.674373,0.012435,0.010363,0.002073
188,966,965,1,ROT,1035,0,4,152,0,208.686809,0.010352,0.010352,0.002073
189,965,967,2,SCHWARZ,1033,1,2,111,0,208.697161,0.049741,0.020725,0.004145
190,967,966,1,SCHWARZ,1034,0,27,236,0,208.746902,0.010341,0.010341,0.004145
191,966,964,2,ROT,1036,0,15,154,0,208.757243,0.041408,0.020704,0.004145
192,964,960,4,SCHWARZ,1040,0,25,240,0,208.798651,0.165975,0.041494,0.004145
193,960,968,8,ROT,1032,1,30,251,0,208.964626,0.800000,0.083333,0.016667
194,968,969,1,ROT,1031,1,21,252,0,209.764626,0.012397,0.010331,0.002066
195,969,970,1,ROT,1030,1,30,253,0,209.777023,0.012384,0.010320,0.002064
196,970,969,1,ROT,1031,0,8,155,0,209.789406,0.010309,0.010309,0.002064
197,969,971,2,SCHWARZ,1029,1,6,113,0,209.799716,0.049536,0.020640,0.004128
198,971,972,1,SCHWARZ,1028,1,6,114,0,209.849251,0.012358,0.010299,0.002060
199,972,971,1,SCHWARZ,1029,0,19,241,0,209.861610,0.010288,0.010288,0.002060
200,971,973,2,ROT,1027,1,5,255,0,209.871898,0.049434,0.020597,0.004119
201,973,972,1,ROT,1028,0,4,156,0,209.921331,0.010277,0.010277,0.004119
202,972,970,2,SCHWARZ,1030,0,34,243,0,209.931609,0.041152,0.020576,0.004119
203,970,966,4,ROT,1034,0,8,160,0,209.972761,0.164948,0.041237,0.004119
204,966,958,8,SCHWARZ,1042,0,34,251,0,210.137710,0.662526,0.082816,0.004119
205,958,974,16,ROT,1026,1,7,271,0,210.800235,3.206681,0.167015,0.033403
206,974,973,1,ROT,1027,0,13,161,0,214.006916,0.010267,0.010267,0.033403
207,973,975,2,SCHWARZ,1025,1,2,116,0,214.017183,0.049332,0.020555,0.004111
208,975,974,1,SCHWARZ,1026,0,34,252,0,214.066515,0.010256,0.010256,0.004111
209,974,976,2,ROT,1024,1,18,273,0,214.076771,0.049281,0.020534,0.004107
210,976,975,1,ROT,1025,0,26,162,0,214.126053,0.010246,0.010246,0.004107
211,975,973,2,SCHWARZ,1027,0,7,254,0,214.136299,0.041026,0.020513,0.004107
212,973,969,4,ROT,1031,0,8,166,0,214.177324,0.164440,0.041110,0.004107
213,969,961,8,SCHWARZ,1039,0,34,262,0,214.341764,0.660475,0.082559,0.004107
214,961,977,16,ROT,1023,1,14,289,0,215.002239,3.196670,0.166493,0.033299
215,977,978,1,ROT,1022,1,12,290,0,218.198909,0.012282,0.010235,0.002047
216,978,979,1,ROT,1021,1,19,291,0,218.211191,0.012270,0.010225,0.002045
217,979,978,1,ROT,1022,0,31,167,0,218.223461,0.010215,0.010215,0.002045
218,978,976,2,SCHWARZ,1024,0,16,264,0,218.233676,0.040900,0.020450,0.002045
219,976,980,4,ROT,1020,1,12,295,0,218.274576,0.196721,0.040984,0.008197
220,980,981,1,ROT,1019,1,7,296,0,218.471297,0.012245,0.010204,0.002041
221,981,980,1,ROT,1020,0,17,168,0,218.483542,0.010194,0.010194,0.002041
222,980,982,2,SCHWARZ,1018,1,29,118,0,218.493736,0.048980,0.020408,0.004082
223,982,981,1,SCHWARZ,1019,0,23,265,0,218.542715,0.010183,0.010183,0.004082
224,981,979,2,ROT,1021,0,17,170,0,218.552898,0.040775,0.020387,0.004082
225,979,975,4,SCHWARZ,1025,0,14,269,0,218.593673,0.163432,0.040858,0.004082
226,975,983,8,ROT,1017,1,30,304,0,218.757105,0.787692,0.082051,0.016410
227,983,984,1,ROT,1016,1,14,305,0,219.544798,0.012208,0.010173,0.002035
228,984,983,1,ROT,1017,0,28,171,0,219.557005,0.010163,0.010163,0.002035
229,983,981,2,SCHWARZ,1019,0,5,271,0,219.567168,0.040692,0.020346,0.002035
230,981,977,4,ROT,1023,0,26,175,0,219.607859,0.163099,0.040775,0.002035
231,977,969,8,SCHWARZ,1031,0,23,279,0,219.770958,0.655067,0.081883,0.002035
232,969,953,16,ROT,1047,0,15,191,0,220.426025,2.641899,0.165119,0.002035
233,953,921,32,SCHWARZ,1079,0,16,311,0,223.067924,10.745016,0.335782,0.002035
234,921,985,64,ROT,1015,1,18,369,0,233.812939,53.368078,0.694897,0.138979
235,985,984,1,ROT,1016,0,6,192,0,287.181018,0.010152,0.010152,0.138979
236,984,986,2,SCHWARZ,1014,1,11,120,0,287.191170,0.048780,0.020325,0.004065
237,986,985,1,SCHWARZ,1015,0,23,312,0,287.239951,0.010142,0.010142,0.004065
238,985,987,2,ROT,1013,1,9,371,0,287.250093,0.048731,0.020305,0.004061
239,987,988,1,ROT,1012,1,23,372,0,287.298823,0.012158,0.010132,0.002026
240,988,987,1,ROT,1013,0,29,193,0,287.310982,0.010121,0.010121,0.002026
241,987,985,2,SCHWARZ,1015,0,34,314,0,287.321103,0.040527,0.020263,0.002026
242,985,981,4,ROT,1019,0,8,197,0,287.361630,0.162437,0.040609,0.002026
243,981,989,8,SCHWARZ,1011,1,15,128,0,287.524066,0.782875,0.081549,0.016310
244,989,990,1,SCHWARZ,1010,1,11,129,0,288.306941,0.012133,0.010111,0.002022
245,990,991,1,SCHWARZ,1009,1,8,130,0,288.319074,0.012121,0.010101,0.002020
246,991,992,1,SCHWARZ,1008,1,17,131,0,288.331196,0.012109,0.010091,0.002018
247,992,991,1,SCHWARZ,1009,0,21,315,0,288.343305,0.010081,0.010081,0.002018
248,991,989,2,ROT,1011,0,2,199,0,288.353385,0.040363,0.020182,0.002018
249,989,993,4,SCHWARZ,1007,1,28,135,0,288.393749,0.194135,0.040445,0.008089
250,993,992,1,SCHWARZ,1008,0,23,316,0,288.587884,0.010070,0.010070,0.008089
251,992,990,2,ROT,1010,0,26,201,0,288.597955,0.040323,0.020161,0.008089
252,990,986,4,SCHWARZ,1014,0,32,320,0,288.638277,0.161616,0.040404,0.008089
253,986,994,8,ROT,1006,1,36,380,0,288.799893,0.778905,0.081136,0.016227
254,994,993,1,ROT,1007,0,0,202,0,289.578798,0.010060,0.010060,0.016227
255,993,991,2,SCHWARZ,1009,0,1,322,0,289.588858,0.040282,0.020141,0.016227
256,991,995,4,ROT,1005,1,30,384,0,289.629140,0.193744,0.040363,0.008073
257,995,996,1,ROT,1004,1,27,385,0,289.822884,0.012060,0.010050,0.002010
258,996,995,1,ROT,1005,0,20,203,0,289.834944,0.010040,0.010040,0.002010
259,995,997,2,SCHWARZ,1003,1,28,137,0,289.844984,0.048241,0.020101,0.004020
260,997,996,1,SCHWARZ,1004,0,32,323,0,289.893226,0.010030,0.010030,0.004020
261,996,994,2,ROT,1006,0,10,205,0,289.903256,0.040161,0.020080,0.004020
262,994,998,4,SCHWARZ,1002,1,8,141,0,289.943416,0.193159,0.040241,0.008048
263,998,997,1,SCHWARZ,1003,0,0,324,0,290.136575,0.010020,0.010020,0.008048
264,997,995,2,ROT,1005,0,24,207,0,290.146595,0.040120,0.020060,0.008048
265,995,999,4,SCHWARZ,1001,1,22,145,0,290.186716,0.192965,0.040201,0.008040
266,999,998,1,SCHWARZ,1002,0,32,325,0,290.379681,0.010010,0.010010,0.008040
267,998,996,2,ROT,1004,0,35,209,0,290.389691,0.040080,0.020040,0.008040
268,996,992,4,SCHWARZ,1008,0,9,329,0,290.429771,0.160643,0.040161,0.008040
269,992,984,8,ROT,1016,0,31,217,0,290.590413,0.645161,0.080645,0.008040
270,984,968,16,SCHWARZ,1032,0,1,345,0,291.235575,2.601626,0.162602,0.008040
271,968,936,32,ROT,1064,0,24,249,0,293.837201,10.578512,0.330579,0.008040
272,936,1000,64,SCHWARZ,1000,1,20,209,0,304.415713,52.512821,0.683761,0.136752
273,1000,999,1,SCHWARZ,1001,0,19,346,0,356.928534,0.010000,0.010000,0.136752
274,999,997,2,ROT,1003,0,15,251,0,356.938534,0.040040,0.020020,0.136752
275,997,993,4,SCHWARZ,1007,0,27,350,0,356.978574,0.160481,0.040120,0.136752
276,993,985,8,ROT,1015,0,20,259,0,357.139055,0.644512,0.080564,0.136752
277,985,969,16,SCHWARZ,1031,0,1,366,0,357.783567,2.598985,0.162437,0.136752
278,969,1001,32,ROT,999,1,9,417,0,360.382552,12.681115,0.330237,0.066047
279,1001,1002,1,ROT,998,1,36,418,0,373.063666,0.011988,0.009990,0.001998
280,1002,1001,1,ROT,999,0,31,260,0,373.075654,0.009980,0.009980,0.001998
281,1001,1003,2,SCHWARZ,997,1,4,211,0,373.085634,0.047952,0.019980,0.003996
282,1003,1004,1,SCHWARZ,996,1,20,212,0,373.133586,0.011964,0.009970,0.001994
283,1004,1005,1,SCHWARZ,995,1,24,213,0,373.145550,0.011952,0.009960,0.001992
284,1005,1006,1,SCHWARZ,994,1,20,214,0,373.157503,0.011940,0.009950,0.001990
285,1006,1007,1,SCHWARZ,993,1,35,215,0,373.169443,0.011928,0.009940,0.001988
286,1007,1008,1,SCHWARZ,992,1,8,216,0,373.181371,0.011917,0.009930,0.001986
287,1008,1007,1,SCHWARZ,993,0,9,367,0,373.193288,0.009921,0.009921,0.001986
288,1007,1009,2,ROT,991,1,36,420,0,373.203208,0.047666,0.019861,0.003972
289,1009,1008,1,ROT,992,0,31,261,0,373.250875,0.009911,0.009911,0.003972
290,1008,1010,2,SCHWARZ,990,1,10,218,0,373.260786,0.047619,0.019841,0.003968
291,1010,1009,1,SCHWARZ,991,0,23,368,0,373.308405,0.009901,0.009901,0.003968
292,1009,1011,2,ROT,989,1,16,422,0,373.318306,0.047572,0.019822,0.003964
293,1011,1012,1,ROT,988,1,5,423,0,373.365877,0.011869,0.009891,0.001978
294,1012,1011,1,ROT,989,0,8,262,0,373.377747,0.009881,0.009881,0.001978
295,1011,1009,2,SCHWARZ,991,0,30,370,0,373.387628,0.039565,0.019782,0.001978
296,1009,1005,4,ROT,995,0,24,266,0,373.427193,0.158573,0.039643,0.001978
297,1005,1013,8,SCHWARZ,987,1,2,226,0,373.585766,0.764179,0.079602,0.015920
298,1013,1014,1,SCHWARZ,986,1,33,227,0,374.349945,0.011846,0.009872,0.001974
299,1014,1013,1,SCHWARZ,987,0,19,371,0,374.361791,0.009862,0.009862,0.001974
300,1013,1015,2,ROT,985,1,9,425,0,374.371653,0.047384,0.019743,0.003949
301,1015,1016,1,ROT,984,1,23,426,0,374.419037,0.011823,0.009852,0.001970
302,1016,1015,1,ROT,985,0,28,267,0,374.430860,0.009843,0.009843,0.001970
303,1015,1013,2,SCHWARZ,987,0,16,373,0,374.440702,0.039409,0.019704,0.001970
304,1013,1017,4,ROT,983,1,19,430,0,374.480111,0.189536,0.039487,0.007897
305,1017,1018,1,ROT,982,1,27,431,0,374.669647,0.011799,0.009833,0.001967
306,1018,1019,1,ROT,981,1,9,432,0,374.681447,0.011788,0.009823,0.001965
307,1019,1018,1,ROT,982,0,35,268,0,374.693234,0.009814,0.009814,0.001965
308,1018,1020,2,SCHWARZ,980,1,35,229,0,374.703048,0.047151,0.019646,0.003929
309,1020,1021,1,SCHWARZ,979,1,31,230,0,374.750199,0.011765,0.009804,0.001961
310,1021,1022,1,SCHWARZ,978,1,29,231,0,374.761964,0.011753,0.009794,0.001959
311,1022,1021,1,SCHWARZ,979,0,23,374,0,374.773717,0.009785,0.009785,0.001959
312,1021,1019,2,ROT,981,0,28,270,0,374.783502,0.039177,0.019589,0.001959
313,1019,1015,4,SCHWARZ,985,0,23,378,0,374.822679,0.157017,0.039254,0.001959
314,1015,1007,8,ROT,993,0,26,278,0,374.979696,0.630542,0.078818,0.001959
315,1007,1023,16,SCHWARZ,977,1,6,247,0,375.610238,3.050645,0.158888,0.031778
316,1023,1022,1,SCHWARZ,978,0,25,379,0,378.660883,0.009775,0.009775,0.031778
317,1022,1024,2,ROT,976,1,16,434,0,378.670658,0.046967,0.019569,0.003914
318,1024,1023,1,ROT,977,0,15,279,0,378.717625,0.009766,0.009766,0.003914
319,1023,1025,2,SCHWARZ,975,1,22,249,0,378.727391,0.046921,0.019550,0.003910
320,1025,1024,1,SCHWARZ,976,0,0,380,0,378.774311,0.009756,0.009756,0.003910
321,1024,1022,2,ROT,978,0,10,281,0,378.784068,0.039062,0.019531,0.003910
322,1022,1026,4,SCHWARZ,974,1,28,253,0,378.823130,0.187867,0.039139,0.007828
323,1026,1027,1,SCHWARZ,973,1,22,254,0,379.010997,0.011696,0.009747,0.001949
324,1027,1028,1,SCHWARZ,972,1,28,255,0,379.022693,0.011685,0.009737,0.001947
325,1028,1029,1,SCHWARZ,971,1,24,256,0,379.034377,0.011673,0.009728,0.001946
326,1029,1028,1,SCHWARZ,972,0,25,381,0,379.046051,0.009718,0.009718,0.001946
327,1028,1030,2,ROT,970,1,23,436,0,379.055769,0.046693,0.019455,0.003891
328,1030,1029,1,ROT,971,0,6,282,0,379.102461,0.009709,0.009709,0.003891
329,1029,1027,2,SCHWARZ,973,0,3,383,0,379.112170,0.038873,0.019436,0.003891
330,1027,1023,4,ROT,977,0,10,286,0,379.151043,0.155794,0.038948,0.003891
331,1023,1031,8,SCHWARZ,969,1,29,264,0,379.306836,0.750733,0.078201,0.015640
332,1031,1032,1,SCHWARZ,968,1,6,265,0,380.057569,0.011639,0.009699,0.001940
333,1032,1031,1,SCHWARZ,969,0,27,384,0,380.069209,0.009690,0.009690,0.001940
334,1031,1033,2,ROT,967,1,19,438,0,380.078899,0.046557,0.019399,0.003880
335,1033,1034,1,ROT,966,1,34,439,0,380.125455,0.011617,0.009681,0.001936
336,1034,1035,1,ROT,965,1,5,440,0,380.137072,0.011605,0.009671,0.001934
337,1035,1034,1,ROT,966,0,4,287,0,380.148677,0.009662,0.009662,0.001934
338,1034,1036,2,SCHWARZ,964,1,28,267,0,380.158339,0.046422,0.019342,0.003868
339,1036,1035,1,SCHWARZ,965,0,30,385,0,380.204761,0.009653,0.009653,0.003868
340,1035,1037,2,ROT,963,1,27,442,0,380.214413,0.046377,0.019324,0.003865
341,1037,1038,1,ROT,962,1,9,443,0,380.260790,0.011572,0.009643,0.001929
342,1038,1037,1,ROT,963,0,35,288,0,380.272362,0.009634,0.009634,0.001929
343,1037,1039,2,SCHWARZ,961,1,24,269,0,380.281996,0.046287,0.019286,0.003857
344,1039,1040,1,SCHWARZ,960,1,13,270,0,380.328283,0.011550,0.009625,0.001925
345,1040,1041,1,SCHWARZ,959,1,31,271,0,380.339833,0.011538,0.009615,0.001923
346,1041,1042,1,SCHWARZ,958,1,20,272,0,380.351371,0.011527,0.009606,0.001921
347,1042,1041,1,SCHWARZ,959,0,23,386,0,380.362899,0.009597,0.009597,0.001921
348,1041,1043,2,ROT,957,1,32,445,0,380.372496,0.046110,0.019212,0.003842
349,1043,1044,1,ROT,956,1,3,446,0,380.418605,0.011505,0.009588,0.001918
350,1044,1043,1,ROT,957,0,20,289,0,380.430110,0.009579,0.009579,0.001918
351,1043,1041,2,SCHWARZ,959,0,18,388,0,380.439689,0.038351,0.019175,0.001918
352,1041,1037,4,ROT,963,0,15,293,0,380.478040,0.153698,0.038425,0.001918
353,1037,1029,8,SCHWARZ,971,0,21,396,0,380.631738,0.617165,0.077146,0.001918
354,1029,1013,16,ROT,987,0,8,309,0,381.248903,2.487852,0.155491,0.001918
355,1013,981,32,SCHWARZ,1019,0,9,428,0,383.736755,10.108588,0.315893,0.001918
356,981,917,64,ROT,1083,0,4,373,0,393.845344,41.753313,0.652396,0.001918
357,917,916,1,SCHWARZ,1084,0,0,429,0,435.598657,0.010905,0.010905,0.001918
358,916,918,2,ROT,1082,1,7,448,0,435.609562,0.052402,0.021834,0.004367
359,918,919,1,ROT,1081,1,23,449,0,435.661964,0.013072,0.010893,0.002179
360,919,920,1,ROT,1080,1,1,450,0,435.675036,0.013058,0.010881,0.002176
361,920,921,1,ROT,1079,1,9,451,0,435.688093,0.013043,0.010870,0.002174
362,921,922,1,ROT,1078,1,36,452,0,435.701137,0.013029,0.010858,0.002172
363,922,923,1,ROT,1077,1,12,453,0,435.714166,0.013015,0.010846,0.002169
364,923,924,1,ROT,1076,1,3,454,0,435.727181,0.013001,0.010834,0.002167
365,924,923,1,ROT,1077,0,4,374,0,435.740182,0.010823,0.010823,0.002167
366,923,921,2,SCHWARZ,1079,0,0,431,0,435.751005,0.043337,0.021668,0.002167
367,921,925,4,ROT,1075,1,34,458,0,435.794342,0.208469,0.043431,0.008686
368,925,926,1,ROT,1074,1,1,459,0,436.002811,0.012973,0.010811,0.002162
369,926,927,1,ROT,1073,1,30,460,0,436.015784,0.012959,0.010799,0.002160
370,927,928,1,ROT,1072,1,36,461,0,436.028743,0.012945,0.010787,0.002157
371,928,929,1,ROT,1071,1,25,462,0,436.041688,0.012931,0.010776,0.002155
372,929,928,1,ROT,1072,0,6,375,0,436.054619,0.010764,0.010764,0.002155
373,928,926,2,SCHWARZ,1074,0,16,433,0,436.065383,0.043103,0.021552,0.002155
374,926,922,4,ROT,1078,0,10,379,0,436.108486,0.172786,0.043197,0.002155
375,922,930,8,SCHWARZ,1070,1,4,280,0,436.281273,0.832972,0.086768,0.017354
376,930,929,1,SCHWARZ,1071,0,30,434,0,437.114244,0.010753,0.010753,0.017354
377,929,927,2,ROT,1073,0,35,381,0,437.124997,0.043057,0.021529,0.017354
378,927,923,4,SCHWARZ,1077,0,19,438,0,437.168054,0.172600,0.043150,0.017354
379,923,931,8,ROT,1069,1,5,470,0,437.340654,0.832069,0.086674,0.017335
380,931,930,1,ROT,1070,0,2,382,0,438.172723,0.010741,0.010741,0.017335
381,930,928,2,SCHWARZ,1072,0,21,440,0,438.183464,0.043011,0.021505,0.017335
382,928,924,4,ROT,1076,0,8,386,0,438.226475,0.172414,0.043103,0.017335
383,924,932,8,SCHWARZ,1068,1,28,288,0,438.398889,0.831169,0.086580,0.017316
384,932,931,1,SCHWARZ,1069,0,19,441,0,439.230058,0.010730,0.010730,0.017316
385,931,933,2,ROT,1067,1,36,472,0,439.240787,0.051557,0.021482,0.004296
386,933,932,1,ROT,1068,0,8,387,0,439.292345,0.010718,0.010718,0.004296
387,932,930,2,SCHWARZ,1070,0,0,443,0,439.303063,0.042918,0.021459,0.004296
388,930,934,4,ROT,1066,1,18,476,0,439.345981,0.206452,0.043011,0.008602
389,934,933,1,ROT,1067,0,22,388,0,439.552433,0.010707,0.010707,0.008602
390,933,931,2,SCHWARZ,1069,0,34,445,0,439.563140,0.042872,0.021436,0.008602
391,931,935,4,ROT,1065,1,23,480,0,439.606012,0.206230,0.042965,0.008593
392,935,936,1,ROT,1064,1,7,481,0,439.812242,0.012834,0.010695,0.002139
393,936,935,1,ROT,1065,0,4,389,0,439.825076,0.010684,0.010684,0.002139
394,935,937,2,SCHWARZ,1063,1,24,290,0,439.835760,0.051337,0.021390,0.004278
395,937,938,1,SCHWARZ,1062,1,4,291,0,439.887097,0.012807,0.010672,0.002134
396,938,937,1,SCHWARZ,1063,0,23,446,0,439.899904,0.010661,0.010661,0.002134
397,937,939,2,ROT,1061,1,32,483,0,439.910565,0.051227,0.021345,0.004269
398,939,940,1,ROT,1060,1,18,484,0,439.961792,0.012780,0.010650,0.002130
399,940,941,1,ROT,1059,1,34,485,0,439.974572,0.012766,0.010638,0.002128
400,941,940,1,ROT,1060,0,20,390,0,439.987338,0.010627,0.010627,0.002128
401,940,938,2,SCHWARZ,1062,0,1,448,0,439.997965,0.042553,0.021277,0.002128
402,938,934,4,ROT,1066,0,8,394,0,440.040518,0.170576,0.042644,0.002128
403,934,942,8,SCHWARZ,1058,1,8,299,0,440.211093,0.822270,0.085653,0.017131
404,942,941,1,SCHWARZ,1059,0,19,449,0,441.033363,0.010616,0.010616,0.017131
405,941,939,2,ROT,1061,0,31,396,0,441.043979,0.042508,0.021254,0.017131
406,939,935,4,SCHWARZ,1065,0,25,453,0,441.086487,0.170394,0.042599,0.017131
407,935,943,8,ROT,1057,1,36,493,0,441.256881,0.821390,0.085561,0.017112
408,943,942,1,ROT,1058,0,10,397,0,442.078271,0.010604,0.010604,0.017112
409,942,940,2,SCHWARZ,1060,0,12,455,0,442.088876,0.042463,0.021231,0.017112
410,940,936,4,ROT,1064,0,15,401,0,442.131339,0.170213,0.042553,0.017112
411,936,944,8,SCHWARZ,1056,1,33,307,0,442.301551,0.820513,0.085470,0.017094
412,944,945,1,SCHWARZ,1055,1,31,308,0,443.122064,0.012712,0.010593,0.002119
413,945,946,1,SCHWARZ,1054,1,15,309,0,443.134776,0.012698,0.010582,0.002116
414,946,947,1,SCHWARZ,1053,1,26,310,0,443.147474,0.012685,0.010571,0.002114
415,947,946,1,SCHWARZ,1054,0,36,456,0,443.160159,0.010560,0.010560,0.002114
416,946,948,2,ROT,1052,1,23,495,0,443.170719,0.050740,0.021142,0.004228
417,948,949,1,ROT,1051,1,27,496,0,443.221459,0.012658,0.010549,0.002110
418,949,950,1,ROT,1050,1,25,497,0,443.234117,0.012645,0.010537,0.002107
419,950,951,1,ROT,1049,1,14,498,0,443.246762,0.012632,0.010526,0.002105
420,951,952,1,ROT,1048,1,23,499,0,443.259394,0.012618,0.010515,0.002103
421,952,953,1,ROT,1047,1,34,500,0,443.272012,0.012605,0.010504,0.002101
422,953,954,1,ROT,1046,1,5,501,0,443.284617,0.012592,0.010493,0.002099
423,954,953,1,ROT,1047,0,33,402,0,443.297209,0.010482,0.010482,0.002099
424,953,955,2,SCHWARZ,1045,1,35,312,0,443.307691,0.050367,0.020986,0.004197
425,955,954,1,SCHWARZ,1046,0,5,457,0,443.358058,0.010471,0.010471,0.004197
426,954,956,2,ROT,1044,1,30,503,0,443.368530,0.050314,0.020964,0.004193
427,956,957,1,ROT,1043,1,27,504,0,443.418844,0.012552,0.010460,0.002092
428,957,956,1,ROT,1044,0,8,403,0,443.431396,0.010449,0.010449,0.002092
429,956,954,2,SCHWARZ,1046,0,18,459,0,443.441846,0.041841,0.020921,0.002092
430,954,958,4,ROT,1042,1,23,508,0,443.483687,0.201258,0.041929,0.008386
431,958,957,1,ROT,1043,0,6,404,0,443.684945,0.010438,0.010438,0.008386
432,957,955,2,SCHWARZ,1045,0,25,461,0,443.695383,0.041797,0.020899,0.008386
433,955,959,4,ROT,1041,1,36,512,0,443.737180,0.201047,0.041885,0.008377
434,959,960,1,ROT,1040,1,16,513,0,443.938227,0.012513,0.010428,0.002086
435,960,959,1,ROT,1041,0,26,405,0,443.950740,0.010417,0.010417,0.002086
436,959,957,2,SCHWARZ,1043,0,16,463,0,443.961157,0.041710,0.020855,0.002086
437,957,961,4,ROT,1039,1,19,517,0,444.002867,0.200627,0.041797,0.008359
438,961,962,1,ROT,1038,1,7,518,0,444.203494,0.012487,0.010406,0.002081
439,962,963,1,ROT,1037,1,23,519,0,444.215981,0.012474,0.010395,0.002079
440,963,964,1,ROT,1036,1,1,520,0,444.228455,0.012461,0.010384,0.002077
441,964,963,1,ROT,1037,0,4,406,0,444.240916,0.010373,0.010373,0.002077
442,963,961,2,SCHWARZ,1039,0,21,465,0,444.251290,0.041537,0.020768,0.002077
443,961,957,4,ROT,1043,0,22,410,0,444.292826,0.166493,0.041623,0.002077
444,957,949,8,SCHWARZ,1051,0,34,473,0,444.459320,0.668757,0.083595,0.002077
445,949,933,16,ROT,1067,0,20,426,0,445.128076,2.697576,0.168599,0.002077
446,933,965,32,SCHWARZ,1035,1,20,344,0,447.825653,13.170418,0.342980,0.068596
447,965,964,1,SCHWARZ,1036,0,0,474,0,460.996071,0.010363,0.010363,0.068596
448,964,966,2,ROT,1034,1,7,522,0,461.006433,0.049793,0.020747,0.004149
449,966,967,1,ROT,1033,1,21,523,0,461.056226,0.012422,0.010352,0.002070
450,967,968,1,ROT,1032,1,1,524,0,461.068648,0.012410,0.010341,0.002068
451,968,967,1,ROT,1033,0,29,427,0,461.081058,0.010331,0.010331,0.002068
452,967,969,2,SCHWARZ,1031,1,35,346,0,461.091388,0.049638,0.020683,0.004137
453,969,970,1,SCHWARZ,1030,1,24,347,0,461.141026,0.012384,0.010320,0.002064
454,970,971,1,SCHWARZ,1029,1,26,348,0,461.153410,0.012371,0.010309,0.002062
455,971,972,1,SCHWARZ,1028,1,10,349,0,461.165781,0.012358,0.010299,0.002060
456,972,971,1,SCHWARZ,1029,0,19,475,0,461.178140,0.010288,0.010288,0.002060
457,971,969,2,ROT,1031,0,2,429,0,461.188428,0.041195,0.020597,0.002060
458,969,965,4,SCHWARZ,1035,0,1,479,0,461.229623,0.165119,0.041280,0.002060
459,965,957,8,ROT,1043,0,8,437,0,461.394741,0.663212,0.082902,0.002060
460,957,973,16,SCHWARZ,1027,1,22,365,0,462.057954,3.210031,0.167189,0.033438
461,973,974,1,SCHWARZ,1026,1,8,366,0,465.267985,0.012333,0.010277,0.002055
462,974,973,1,SCHWARZ,1027,0,30,480,0,465.280318,0.010267,0.010267,0.002055
463,973,975,2,ROT,1025,1,25,526,0,465.290585,0.049332,0.020555,0.004111
464,975,976,1,ROT,1024,1,12,527,0,465.339917,0.012308,0.010256,0.002051
465,976,977,1,ROT,1023,1,21,528,0,465.352225,0.012295,0.010246,0.002049
466,977,978,1,ROT,1022,1,19,529,0,465.364520,0.012282,0.010235,0.002047
467,978,977,1,ROT,1023,0,10,438,0,465.376802,0.010225,0.010225,0.002047
468,977,979,2,SCHWARZ,1021,1,2,368,0,465.387027,0.049130,0.020471,0.004094
469,979,980,1,SCHWARZ,1020,1,2,369,0,465.436157,0.012257,0.010215,0.002043
470,980,981,1,SCHWARZ,1019,1,33,370,0,465.448415,0.012245,0.010204,0.002041
471,981,982,1,SCHWARZ,1018,1,24,371,0,465.460659,0.012232,0.010194,0.002039
472,982,981,1,SCHWARZ,1019,0,36,481,0,465.472892,0.010183,0.010183,0.002039
473,981,979,2,ROT,1021,0,6,440,0,465.483075,0.040775,0.020387,0.002039
474,979,983,4,SCHWARZ,1017,1,4,375,0,465.523850,0.196118,0.040858,0.008172
475,983,982,1,SCHWARZ,1018,0,21,482,0,465.719968,0.010173,0.010173,0.008172
476,982,984,2,ROT,1016,1,9,531,0,465.730141,0.048880,0.020367,0.004073
477,984,985,1,ROT,1015,1,36,532,0,465.779021,0.012195,0.010163,0.002033
478,985,986,1,ROT,1014,1,12,533,0,465.791216,0.012183,0.010152,0.002030
479,986,987,1,ROT,1013,1,19,534,0,465.803399,0.012170,0.010142,0.002028
480,987,988,1,ROT,1012,1,23,535,0,465.815569,0.012158,0.010132,0.002026
481,988,987,1,ROT,1013,0,29,441,0,465.827727,0.010121,0.010121,0.002026
482,987,989,2,SCHWARZ,1011,1,2,377,0,465.837849,0.048632,0.020263,0.004053
483,989,990,1,SCHWARZ,1010,1,26,378,0,465.886481,0.012133,0.010111,0.002022
484,990,991,1,SCHWARZ,1009,1,31,379,0,465.898615,0.012121,0.010101,0.002020
485,991,990,1,SCHWARZ,1010,0,3,483,0,465.910736,0.010091,0.010091,0.002020
486,990,992,2,ROT,1008,1,27,537,0,465.920827,0.048485,0.020202,0.004040
487,992,993,1,ROT,1007,1,27,538,0,465.969311,0.012097,0.010081,0.002016
488,993,994,1,ROT,1006,1,12,539,0,465.981408,0.012085,0.010070,0.002014
489,994,995,1,ROT,1005,1,5,540,0,465.993493,0.012072,0.010060,0.002012
490,995,996,1,ROT,1004,1,12,541,0,466.005565,0.012060,0.010050,0.002010
491,996,995,1,ROT,1005,0,17,442,0,466.017626,0.010040,0.010040,0.002010
492,995,997,2,SCHWARZ,1003,1,33,381,0,466.027666,0.048241,0.020101,0.004020
493,997,996,1,SCHWARZ,1004,0,25,484,0,466.075907,0.010030,0.010030,0.004020
494,996,998,2,ROT,1002,1,16,543,0,466.085937,0.048193,0.020080,0.004016
495,998,997,1,ROT,1003,0,26,443,0,466.134130,0.010020,0.010020,0.004016
496,997,995,2,SCHWARZ,1005,0,21,486,0,466.144150,0.040120,0.020060,0.004016
497,995,999,4,ROT,1001,1,23,547,0,466.184270,0.192965,0.040201,0.008040
498,999,998,1,ROT,1002,0,2,444,0,466.377235,0.010010,0.010010,0.008040
499,998,1000,2,SCHWARZ,1000,1,20,383,0,466.387245,0.048096,0.020040,0.004008
500,1000,999,1,SCHWARZ,1001,0,23,487,0,466.435341,0.010000,0.010000,0.004008
501,999,1001,2,ROT,999,1,18,549,0,466.445341,0.048048,0.020020,0.004004
502,1001,1002,1,ROT,998,1,21,550,0,466.493389,0.011988,0.009990,0.001998
503,1002,1003,1,ROT,997,1,3,551,0,466.505377,0.011976,0.009980,0.001996
504,1003,1004,1,ROT,996,1,7,552,0,466.517353,0.011964,0.009970,0.001994
505,1004,1003,1,ROT,997,0,22,445,0,466.529317,0.009960,0.009960,0.001994
506,1003,1005,2,SCHWARZ,995,1,4,385,0,466.539278,0.047856,0.019940,0.003988
507,1005,1006,1,SCHWARZ,994,1,17,386,0,466.587134,0.011940,0.009950,0.001990
508,1006,1007,1,SCHWARZ,993,1,24,387,0,466.599074,0.011928,0.009940,0.001988
509,1007,1008,1,SCHWARZ,992,1,17,388,0,466.611003,0.011917,0.009930,0.001986
510,1008,1007,1,SCHWARZ,993,0,9,488,0,466.622919,0.009921,0.009921,0.001986
511,1007,1005,2,ROT,995,0,22,447,0,466.632840,0.039722,0.019861,0.001986
512,1005,1009,4,SCHWARZ,991,1,2,392,0,466.672562,0.191045,0.039801,0.007960
513,1009,1008,1,SCHWARZ,992,0,27,489,0,466.863607,0.009911,0.009911,0.007960
514,1008,1010,2,ROT,990,1,12,554,0,466.873518,0.047619,0.019841,0.003968
515,1010,1011,1,ROT,989,1,12,555,0,466.921137,0.011881,0.009901,0.001980
516,1011,1012,1,ROT,988,1,7,556,0,466.933018,0.011869,0.009891,0.001978
517,1012,1013,1,ROT,987,1,14,557,0,466.944887,0.011858,0.009881,0.001976
518,1013,1014,1,ROT,986,1,23,558,0,466.956745,0.011846,0.009872,0.001974
519,1014,1013,1,ROT,987,0,2,448,0,466.968591,0.009862,0.009862,0.001974
520,1013,1011,2,SCHWARZ,989,0,14,491,0,466.978453,0.039487,0.019743,0.001974
521,1011,1007,4,ROT,993,0,8,452,0,467.017940,0.158259,0.039565,0.001974
522,1007,1015,8,SCHWARZ,985,1,33,400,0,467.176199,0.762661,0.079444,0.015889
523,1015,1016,1,SCHWARZ,984,1,4,401,0,467.938860,0.011823,0.009852,0.001970
524,1016,1015,1,SCHWARZ,985,0,5,492,0,467.950683,0.009843,0.009843,0.001970
525,1015,1013,2,ROT,987,0,11,454,0,467.960525,0.039409,0.019704,0.001970
526,1013,1009,4,SCHWARZ,991,0,14,496,0,467.999934,0.157947,0.039487,0.001970
527,1009,1001,8,ROT,999,0,17,462,0,468.157881,0.634291,0.079286,0.001970
528,1001,1017,16,SCHWARZ,983,1,6,417,0,468.792172,3.068931,0.159840,0.031968
529,1017,1016,1,SCHWARZ,984,0,1,497,0,471.861103,0.009833,0.009833,0.031968
530,1016,1018,2,ROT,982,1,32,560,0,471.870936,0.047244,0.019685,0.003937
531,1018,1017,1,ROT,983,0,20,463,0,471.918180,0.009823,0.009823,0.003937
532,1017,1015,2,SCHWARZ,985,0,25,499,0,471.928003,0.039331,0.019666,0.003937
533,1015,1011,4,ROT,989,0,24,467,0,471.967335,0.157635,0.039409,0.003937
534,1011,1003,8,SCHWARZ,997,0,18,507,0,472.124970,0.633037,0.079130,0.003937
535,1003,1019,16,ROT,981,1,9,576,0,472.758007,3.062812,0.159521,0.031904
536,1019,1018,1,ROT,982,0,22,468,0,475.820818,0.009814,0.009814,0.031904
537,1018,1020,2,SCHWARZ,980,1,4,419,0,475.830632,0.047151,0.019646,0.003929
538,1020,1019,1,SCHWARZ,981,0,27,508,0,475.877783,0.009804,0.009804,0.003929
539,1019,1017,2,ROT,983,0,33,470,0,475.887587,0.039254,0.019627,0.003929
540,1017,1013,4,SCHWARZ,987,0,36,512,0,475.926841,0.157325,0.039331,0.003929
541,1013,1021,8,ROT,979,1,1,584,0,476.084167,0.758144,0.078973,0.015795
542,1021,1022,1,ROT,978,1,19,585,0,476.842311,0.011753,0.009794,0.001959
543,1022,1023,1,ROT,977,1,14,586,0,476.854064,0.011742,0.009785,0.001957
544,1023,1022,1,ROT,978,0,17,471,0,476.865806,0.009775,0.009775,0.001957
545,1022,1020,2,SCHWARZ,980,0,34,514,0,476.875581,0.039139,0.019569,0.001957
546,1020,1024,4,ROT,976,1,23,590,0,476.914720,0.188235,0.039216,0.007843
547,1024,1023,1,ROT,977,0,22,472,0,477.102955,0.009766,0.009766,0.007843
548,1023,1025,2,SCHWARZ,975,1,35,421,0,477.112721,0.046921,0.019550,0.003910
549,1025,1026,1,SCHWARZ,974,1,22,422,0,477.159642,0.011707,0.009756,0.001951
550,1026,1025,1,SCHWARZ,975,0,16,515,0,477.171349,0.009747,0.009747,0.001951
551,1025,1027,2,ROT,973,1,5,592,0,477.181095,0.046829,0.019512,0.003902
552,1027,1026,1,ROT,974,0,8,473,0,477.227925,0.009737,0.009737,0.003902
553,1026,1028,2,SCHWARZ,972,1,11,424,0,477.237662,0.046784,0.019493,0.003899
554,1028,1027,1,SCHWARZ,973,0,3,516,0,477.284445,0.009728,0.009728,0.003899
555,1027,1025,2,ROT,975,0,35,475,0,477.294173,0.038948,0.019474,0.003899
556,1025,1021,4,SCHWARZ,979,0,9,520,0,477.333121,0.156098,0.039024,0.003899
557,1021,1013,8,ROT,987,0,24,483,0,477.489219,0.626836,0.078355,0.003899
558,1013,997,16,SCHWARZ,1003,0,12,536,0,478.116055,2.527147,0.157947,0.003899
559,997,1029,32,ROT,971,1,25,624,0,480.643203,12.324975,0.320963,0.064193
560,1029,1028,1,ROT,972,0,10,484,0,492.968178,0.009718,0.009718,0.064193
561,1028,1030,2,SCHWARZ,970,1,11,426,0,492.977896,0.046693,0.019455,0.003891
562,1030,1031,1,SCHWARZ,969,1,4,427,0,493.024588,0.011650,0.009709,0.001942
563,1031,1030,1,SCHWARZ,970,0,36,537,0,493.036239,0.009699,0.009699,0.001942
564,1030,1032,2,ROT,968,1,23,626,0,493.045938,0.046602,0.019417,0.003883
565,1032,1031,1,ROT,969,0,33,485,0,493.092540,0.009690,0.009690,0.003883
566,1031,1033,2,SCHWARZ,967,1,17,429,0,493.102230,0.046557,0.019399,0.003880
567,1033,1034,1,SCHWARZ,966,1,17,430,0,493.148787,0.011617,0.009681,0.001936
568,1034,1035,1,SCHWARZ,965,1,20,431,0,493.160403,0.011605,0.009671,0.001934
569,1035,1036,1,SCHWARZ,964,1,2,432,0,493.172009,0.011594,0.009662,0.001932
570,1036,1037,1,SCHWARZ,963,1,10,433,0,493.183603,0.011583,0.009653,0.001931
571,1037,1036,1,SCHWARZ,964,0,3,538,0,493.195186,0.009643,0.009643,0.001931
572,1036,1038,2,ROT,962,1,27,628,0,493.204829,0.046332,0.019305,0.003861
573,1038,1037,1,ROT,963,0,13,486,0,493.251161,0.009634,0.009634,0.003861
574,1037,1039,2,SCHWARZ,961,1,35,435,0,493.260795,0.046287,0.019286,0.003857
575,1039,1038,1,SCHWARZ,962,0,3,539,0,493.307083,0.009625,0.009625,0.003857
576,1038,1036,2,ROT,964,0,10,488,0,493.316707,0.038536,0.019268,0.003857
577,1036,1032,4,SCHWARZ,968,0,36,543,0,493.355243,0.154440,0.038610,0.003857
578,1032,1024,8,ROT,976,0,35,496,0,493.509683,0.620155,0.077519,0.003857
579,1024,1008,16,SCHWARZ,992,0,1,559,0,494.129838,2.500000,0.156250,0.003857
580,1008,976,32,ROT,1024,0,29,528,0,496.629838,10.158730,0.317460,0.003857
581,976,912,64,SCHWARZ,1088,0,21,623,0,506.788568,41.967213,0.655738,0.003857
582,912,911,1,ROT,1089,0,2,529,0,548.755781,0.010965,0.010965,0.003857
583,911,913,2,SCHWARZ,1087,1,8,437,0,548.766746,0.052689,0.021954,0.004391
584,913,914,1,SCHWARZ,1086,1,20,438,0,548.819436,0.013143,0.010953,0.002191
585,914,913,1,SCHWARZ,1087,0,23,624,0,548.832579,0.010941,0.010941,0.002191
586,913,911,2,ROT,1089,0,20,531,0,548.843520,0.043812,0.021906,0.002191
587,911,915,4,SCHWARZ,1085,1,22,442,0,548.887332,0.210757,0.043908,0.008782
588,915,914,1,SCHWARZ,1086,0,36,625,0,549.098089,0.010929,0.010929,0.008782
589,914,912,2,ROT,1088,0,26,533,0,549.109018,0.043764,0.021882,0.008782
590,912,908,4,SCHWARZ,1092,0,25,629,0,549.152782,0.175439,0.043860,0.008782
591,908,916,8,ROT,1084,1,36,636,0,549.328220,0.845815,0.088106,0.017621
592,916,917,1,ROT,1083,1,34,637,0,550.174035,0.013100,0.010917,0.002183
593,917,918,1,ROT,1082,1,12,638,0,550.187136,0.013086,0.010905,0.002181
594,918,917,1,ROT,1083,0,24,534,0,550.200222,0.010893,0.010893,0.002181
595,917,915,2,SCHWARZ,1085,0,0,631,0,550.211115,0.043621,0.021810,0.002181
596,915,911,4,ROT,1089,0,28,538,0,550.254736,0.174863,0.043716,0.002181
597,911,919,8,SCHWARZ,1081,1,33,450,0,550.429599,0.843030,0.087816,0.017563
598,919,920,1,SCHWARZ,1080,1,26,451,0,551.272629,0.013058,0.010881,0.002176
599,920,919,1,SCHWARZ,1081,0,7,632,0,551.285686,0.010870,0.010870,0.002176
600,919,921,2,ROT,1079,1,25,640,0,551.296556,0.052231,0.021763,0.004353
601,921,922,1,ROT,1078,1,16,641,0,551.348786,0.013029,0.010858,0.002172
602,922,921,1,ROT,1079,0,10,539,0,551.361816,0.010846,0.010846,0.002172
603,921,923,2,SCHWARZ,1077,1,22,453,0,551.372662,0.052117,0.021716,0.004343
604,923,922,1,SCHWARZ,1078,0,1,633,0,551.424779,0.010834,0.010834,0.004343
605,922,924,2,ROT,1076,1,25,643,0,551.435613,0.052061,0.021692,0.004338
606,924,925,1,ROT,1075,1,32,644,0,551.487674,0.012987,0.010823,0.002165
607,925,926,1,ROT,1074,1,9,645,0,551.500661,0.012973,0.010811,0.002162
608,926,925,1,ROT,1075,0,10,540,0,551.513634,0.010799,0.010799,0.002162
609,925,923,2,SCHWARZ,1077,0,25,635,0,551.524433,0.043243,0.021622,0.002162
610,923,927,4,ROT,1073,1,7,649,0,551.567676,0.208017,0.043337,0.008667
611,927,928,1,ROT,1072,1,7,650,0,551.775694,0.012945,0.010787,0.002157
612,928,929,1,ROT,1071,1,5,651,0,551.788639,0.012931,0.010776,0.002155
613,929,928,1,ROT,1072,0,10,541,0,551.801570,0.010764,0.010764,0.002155
614,928,926,2,SCHWARZ,1074,0,23,637,0,551.812334,0.043103,0.021552,0.002155
615,926,930,4,ROT,1070,1,12,655,0,551.855437,0.207343,0.043197,0.008639
616,930,931,1,ROT,1069,1,30,656,0,552.062781,0.012903,0.010753,0.002151
617,931,932,1,ROT,1068,1,16,657,0,552.075684,0.012889,0.010741,0.002148
618,932,931,1,ROT,1069,0,24,542,0,552.088573,0.010730,0.010730,0.002148
619,931,929,2,SCHWARZ,1071,0,0,639,0,552.099303,0.042965,0.021482,0.002148
620,929,925,4,ROT,1075,0,13,546,0,552.142268,0.172228,0.043057,0.002148
621,925,933,8,SCHWARZ,1067,1,11,461,0,552.314496,0.830270,0.086486,0.017297
622,933,934,1,SCHWARZ,1066,1,22,462,0,553.144766,0.012862,0.010718,0.002144
623,934,933,1,SCHWARZ,1067,0,21,640,0,553.157628,0.010707,0.010707,0.002144
624,933,931,2,ROT,1069,0,17,548,0,553.168334,0.042872,0.021436,0.002144
625,931,927,4,SCHWARZ,1073,0,1,644,0,553.211207,0.171858,0.042965,0.002144
626,927,935,8,ROT,1065,1,32,665,0,553.383065,0.828479,0.086300,0.017260
627,935,936,1,ROT,1064,1,34,666,0,554.211544,0.012834,0.010695,0.002139
628,936,937,1,ROT,1063,1,30,667,0,554.224378,0.012821,0.010684,0.002137
629,937,936,1,ROT,1064,0,11,549,0,554.237199,0.010672,0.010672,0.002137
630,936,938,2,SCHWARZ,1062,1,24,464,0,554.247871,0.051282,0.021368,0.004274
631,938,937,1,SCHWARZ,1063,0,16,645,0,554.299153,0.010661,0.010661,0.004274
632,937,935,2,ROT,1065,0,24,551,0,554.309814,0.042689,0.021345,0.004274
633,935,931,4,SCHWARZ,1069,0,32,649,0,554.352504,0.171123,0.042781,0.004274
634,931,939,8,ROT,1061,1,19,675,0,554.523627,0.824919,0.085929,0.017186
635,939,940,1,ROT,1060,1,30,676,0,555.348546,0.012780,0.010650,0.002130
636,940,941,1,ROT,1059,1,9,677,0,555.361326,0.012766,0.010638,0.002128
637,941,940,1,ROT,1060,0,8,552,0,555.374092,0.010627,0.010627,0.002128
638,940,938,2,SCHWARZ,1062,0,14,651,0,555.384719,0.042553,0.021277,0.002128
639,938,942,4,ROT,1058,1,1,681,0,555.427272,0.204691,0.042644,0.008529
640,942,941,1,ROT,1059,0,31,553,0,555.631963,0.010616,0.010616,0.008529
641,941,943,2,SCHWARZ,1057,1,24,466,0,555.642578,0.051010,0.021254,0.004251
642,943,942,1,SCHWARZ,1058,0,5,652,0,555.693588,0.010604,0.010604,0.004251
643,942,944,2,ROT,1056,1,5,683,0,555.704192,0.050955,0.021231,0.004246
644,944,943,1,ROT,1057,0,15,554,0,555.755148,0.010593,0.010593,0.004246
645,943,945,2,SCHWARZ,1055,1,6,468,0,555.765741,0.050901,0.021209,0.004242
646,945,946,1,SCHWARZ,1054,1,24,469,0,555.816642,0.012698,0.010582,0.002116
647,946,945,1,SCHWARZ,1055,0,30,653,0,555.829341,0.010571,0.010571,0.002116
648,945,947,2,ROT,1053,1,3,685,0,555.839912,0.050794,0.021164,0.004233
649,947,948,1,ROT,1052,1,18,686,0,555.890705,0.012672,0.010560,0.002112
650,948,949,1,ROT,1051,1,3,687,0,555.903377,0.012658,0.010549,0.002110
651,949,948,1,ROT,1052,0,2,555,0,555.916035,0.010537,0.010537,0.002110
652,948,950,2,SCHWARZ,1050,1,6,471,0,555.926572,0.050633,0.021097,0.004219
653,950,951,1,SCHWARZ,1049,1,13,472,0,555.977205,0.012632,0.010526,0.002105
654,951,952,1,SCHWARZ,1048,1,24,473,0,555.989837,0.012618,0.010515,0.002103
655,952,953,1,SCHWARZ,1047,1,6,474,0,556.002455,0.012605,0.010504,0.002101
656,953,952,1,SCHWARZ,1048,0,25,654,0,556.015060,0.010493,0.010493,0.002101
657,952,954,2,ROT,1046,1,3,689,0,556.025553,0.050420,0.021008,0.004202
658,954,953,1,ROT,1047,0,2,556,0,556.075974,0.010482,0.010482,0.004202
659,953,951,2,SCHWARZ,1049,0,36,656,0,556.086456,0.041973,0.020986,0.004202
660,951,947,4,ROT,1053,0,28,560,0,556.128429,0.168244,0.042061,0.004202
661,947,955,8,SCHWARZ,1045,1,24,482,0,556.296673,0.810982,0.084477,0.016895
662,955,956,1,SCHWARZ,1044,1,26,483,0,557.107655,0.012565,0.010471,0.002094
663,956,957,1,SCHWARZ,1043,1,17,484,0,557.120220,0.012552,0.010460,0.002092
664,957,958,1,SCHWARZ,1042,1,2,485,0,557.132772,0.012539,0.010449,0.002090
665,958,957,1,SCHWARZ,1043,0,34,657,0,557.145311,0.010438,0.010438,0.002090
666,957,955,2,ROT,1045,0,17,562,0,557.155750,0.041797,0.020899,0.002090
667,955,959,4,SCHWARZ,1041,1,26,489,0,557.197547,0.201047,0.041885,0.008377
668,959,958,1,SCHWARZ,1042,0,18,658,0,557.398594,0.010428,0.010428,0.008377
669,958,956,2,ROT,1044,0,15,564,0,557.409022,0.041754,0.020877,0.008377
670,956,960,4,SCHWARZ,1040,1,2,493,0,557.450775,0.200837,0.041841,0.008368
671,960,961,1,SCHWARZ,1039,1,6,494,0,557.651612,0.012500,0.010417,0.002083
672,961,962,1,SCHWARZ,1038,1,11,495,0,557.664112,0.012487,0.010406,0.002081
673,962,963,1,SCHWARZ,1037,1,33,496,0,557.676599,0.012474,0.010395,0.002079
674,963,964,1,SCHWARZ,1036,1,20,497,0,557.689073,0.012461,0.010384,0.002077
675,964,963,1,SCHWARZ,1037,0,18,659,0,557.701534,0.010373,0.010373,0.002077
676,963,965,2,ROT,1035,1,16,691,0,557.711908,0.049844,0.020768,0.004154
677,965,966,1,ROT,1034,1,23,692,0,557.761752,0.012435,0.010363,0.002073
678,966,965,1,ROT,1035,0,33,565,0,557.774187,0.010352,0.010352,0.002073
679,965,963,2,SCHWARZ,1037,0,9,661,0,557.784539,0.041451,0.020725,0.002073
680,963,959,4,ROT,1041,0,15,569,0,557.825990,0.166147,0.041537,0.002073
681,959,951,8,SCHWARZ,1049,0,5,669,0,557.992137,0.667362,0.083420,0.002073
682,951,967,16,ROT,1033,1,9,708,0,558.659499,3.230284,0.168244,0.033649
683,967,968,1,ROT,1032,1,34,709,0,561.889783,0.012410,0.010341,0.002068
684,968,967,1,ROT,1033,0,35,570,0,561.902193,0.010331,0.010331,0.002068
685,967,965,2,SCHWARZ,1035,0,9,671,0,561.912523,0.041365,0.020683,0.002068
686,965,961,4,ROT,1039,0,24,574,0,561.953888,0.165803,0.041451,0.002068
687,961,969,8,SCHWARZ,1031,1,6,505,0,562.119691,0.799168,0.083247,0.016649
688,969,968,1,SCHWARZ,1032,0,3,672,0,562.918859,0.010320,0.010320,0.016649
689,968,966,2,ROT,1034,0,28,576,0,562.929179,0.041322,0.020661,0.016649
690,966,970,4,SCHWARZ,1030,1,6,509,0,562.970501,0.198758,0.041408,0.008282
691,970,971,1,SCHWARZ,1029,1,29,510,0,563.169259,0.012371,0.010309,0.002062
692,971,970,1,SCHWARZ,1030,0,27,673,0,563.181630,0.010299,0.010299,0.002062
693,970,972,2,ROT,1028,1,30,711,0,563.191929,0.049485,0.020619,0.004124
694,972,971,1,ROT,1029,0,2,577,0,563.241413,0.010288,0.010288,0.004124
695,971,973,2,SCHWARZ,1027,1,10,512,0,563.251701,0.049434,0.020597,0.004119
696,973,972,1,SCHWARZ,1028,0,19,674,0,563.301135,0.010277,0.010277,0.004119
697,972,970,2,ROT,1030,0,33,579,0,563.311412,0.041152,0.020576,0.004119
698,970,974,4,SCHWARZ,1026,1,8,516,0,563.352565,0.197938,0.041237,0.008247
699,974,973,1,SCHWARZ,1027,0,14,675,0,563.550503,0.010267,0.010267,0.008247
700,973,975,2,ROT,1025,1,23,713,0,563.560770,0.049332,0.020555,0.004111
701,975,974,1,ROT,1026,0,6,580,0,563.610102,0.010256,0.010256,0.004111
702,974,972,2,SCHWARZ,1028,0,0,677,0,563.620358,0.041068,0.020534,0.004111
703,972,968,4,ROT,1032,0,15,584,0,563.661426,0.164609,0.041152,0.004111
704,968,960,8,SCHWARZ,1040,0,19,685,0,563.826035,0.661157,0.082645,0.004111
705,960,944,16,ROT,1056,0,33,600,0,564.487192,2.666667,0.166667,0.004111
706,944,976,32,SCHWARZ,1024,1,6,548,0,567.153859,13.016949,0.338983,0.067797
707,976,977,1,SCHWARZ,1023,1,31,549,0,580.170808,0.012295,0.010246,0.002049
708,977,976,1,SCHWARZ,1024,0,25,686,0,580.183103,0.010235,0.010235,0.002049
709,976,974,2,ROT,1026,0,24,602,0,580.193338,0.040984,0.020492,0.002049
710,974,970,4,SCHWARZ,1030,0,16,690,0,580.234322,0.164271,0.041068,0.002049
711,970,962,8,ROT,1038,0,2,610,0,580.398593,0.659794,0.082474,0.002049
712,962,946,16,SCHWARZ,1054,0,18,706,0,581.058387,2.661123,0.166320,0.002049
713,946,914,32,ROT,1086,0,0,642,0,583.719510,10.824524,0.338266,0.002049
714,914,978,64,SCHWARZ,1022,1,29,613,0,594.544034,53.776805,0.700219,0.140044
715,978,977,1,SCHWARZ,1023,0,3,707,0,648.320839,0.010225,0.010225,0.140044
716,977,975,2,ROT,1025,0,26,644,0,648.331064,0.040942,0.020471,0.140044
717,975,971,4,SCHWARZ,1029,0,25,711,0,648.372006,0.164103,0.041026,0.140044
718,971,979,8,ROT,1021,1,1,721,0,648.536108,0.790937,0.082389,0.016478
719,979,978,1,ROT,1022,0,11,645,0,649.327046,0.010215,0.010215,0.016478
720,978,976,2,SCHWARZ,1024,0,32,713,0,649.337260,0.040900,0.020450,0.016478
721,976,972,4,ROT,1028,0,13,649,0,649.378160,0.163934,0.040984,0.016478
722,972,964,8,SCHWARZ,1036,0,16,721,0,649.542094,0.658436,0.082305,0.016478
723,964,980,16,ROT,1020,1,1,737,0,650.200531,3.186722,0.165975,0.033195
724,980,979,1,ROT,1021,0,20,650,0,653.387253,0.010204,0.010204,0.033195
725,979,977,2,SCHWARZ,1023,0,5,723,0,653.397457,0.040858,0.020429,0.033195
726,977,981,4,ROT,1019,1,5,741,0,653.438315,0.196520,0.040942,0.008188
727,981,982,1,ROT,1018,1,7,742,0,653.634835,0.012232,0.010194,0.002039
728,982,983,1,ROT,1017,1,27,743,0,653.647067,0.012220,0.010183,0.002037
729,983,984,1,ROT,1016,1,34,744,0,653.659287,0.012208,0.010173,0.002035
730,984,985,1,ROT,1015,1,1,745,0,653.671494,0.012195,0.010163,0.002033
731,985,986,1,ROT,1014,1,34,746,0,653.683690,0.012183,0.010152,0.002030
732,986,985,1,ROT,1015,0,0,651,0,653.695872,0.010142,0.010142,0.002030
733,985,983,2,SCHWARZ,1017,0,16,725,0,653.706014,0.040609,0.020305,0.002030
734,983,987,4,ROT,1013,1,9,750,0,653.746623,0.195320,0.040692,0.008138
735,987,986,1,ROT,1014,0,10,652,0,653.941944,0.010132,0.010132,0.008138
736,986,984,2,SCHWARZ,1016,0,12,727,0,653.952076,0.040568,0.020284,0.008138
737,984,988,4,ROT,1012,1,25,754,0,653.992644,0.195122,0.040650,0.008130
738,988,987,1,ROT,1013,0,13,653,0,654.187766,0.010121,0.010121,0.008130
739,987,989,2,SCHWARZ,1011,1,31,615,0,654.197887,0.048632,0.020263,0.004053
740,989,990,1,SCHWARZ,1010,1,26,616,0,654.246519,0.012133,0.010111,0.002022
741,990,989,1,SCHWARZ,1011,0,21,728,0,654.258653,0.010101,0.010101,0.002022
742,989,987,2,ROT,1013,0,31,655,0,654.268754,0.040445,0.020222,0.002022
743,987,991,4,SCHWARZ,1009,1,22,620,0,654.309199,0.194529,0.040527,0.008105
744,991,992,1,SCHWARZ,1008,1,13,621,0,654.503727,0.012109,0.010091,0.002018
745,992,991,1,SCHWARZ,1009,0,0,729,0,654.515836,0.010081,0.010081,0.002018
746,991,989,2,ROT,1011,0,28,657,0,654.525917,0.040363,0.020182,0.002018
747,989,985,4,SCHWARZ,1015,0,14,733,0,654.566280,0.161780,0.040445,0.002018
748,985,993,8,ROT,1007,1,9,762,0,654.728060,0.779695,0.081218,0.016244
749,993,992,1,ROT,1008,0,15,658,0,655.507755,0.010070,0.010070,0.016244
750,992,990,2,SCHWARZ,1010,0,16,735,0,655.517826,0.040323,0.020161,0.016244
751,990,994,4,ROT,1006,1,30,766,0,655.558148,0.193939,0.040404,0.008081
752,994,993,1,ROT,1007,0,22,659,0,655.752088,0.010060,0.010060,0.008081
753,993,991,2,SCHWARZ,1009,0,9,737,0,655.762148,0.040282,0.020141,0.008081
754,991,995,4,ROT,1005,1,30,770,0,655.802430,0.193744,0.040363,0.008073
755,995,994,1,ROT,1006,0,29,660,0,655.996174,0.010050,0.010050,0.008073
756,994,992,2,SCHWARZ,1008,0,23,739,0,656.006224,0.040241,0.020121,0.008073
757,992,996,4,ROT,1004,1,14,774,0,656.046466,0.193548,0.040323,0.008065
758,996,995,1,ROT,1005,0,22,661,0,656.240014,0.010040,0.010040,0.008065
759,995,993,2,SCHWARZ,1007,0,25,741,0,656.250054,0.040201,0.020101,0.008065
760,993,989,4,ROT,1011,0,20,665,0,656.290255,0.161128,0.040282,0.008065
761,989,981,8,SCHWARZ,1019,0,3,749,0,656.451383,0.647118,0.080890,0.008065
762,981,997,16,ROT,1003,1,19,790,0,657.098501,3.131498,0.163099,0.032620
763,997,996,1,ROT,1004,0,31,666,0,660.230000,0.010030,0.010030,0.032620
764,996,998,2,SCHWARZ,1002,1,20,623,0,660.240030,0.048193,0.020080,0.004016
765,998,997,1,SCHWARZ,1003,0,18,750,0,660.288223,0.010020,0.010020,0.004016
766,997,995,2,ROT,1005,0,13,668,0,660.298243,0.040120,0.020060,0.004016
767,995,991,4,SCHWARZ,1009,0,16,754,0,660.338363,0.160804,0.040201,0.004016
768,991,983,8,ROT,1017,0,2,676,0,660.499167,0.645812,0.080727,0.004016
769,983,999,16,SCHWARZ,1001,1,24,639,0,661.144979,3.125127,0.162767,0.032553
770,999,998,1,SCHWARZ,1002,0,3,755,0,664.270107,0.010010,0.010010,0.032553
771,998,1000,2,ROT,1000,1,14,792,0,664.280117,0.048096,0.020040,0.004008
772,1000,1001,1,ROT,999,1,27,793,0,664.328213,0.012000,0.010000,0.002000
773,1001,1002,1,ROT,998,1,12,794,0,664.340213,0.011988,0.009990,0.001998
774,1002,1001,1,ROT,999,0,11,677,0,664.352201,0.009980,0.009980,0.001998
775,1001,1003,2,SCHWARZ,997,1,13,641,0,664.362181,0.047952,0.019980,0.003996
776,1003,1004,1,SCHWARZ,996,1,13,642,0,664.410133,0.011964,0.009970,0.001994
777,1004,1003,1,SCHWARZ,997,0,5,756,0,664.422097,0.009960,0.009960,0.001994
778,1003,1001,2,ROT,999,0,13,679,0,664.432057,0.039880,0.019940,0.001994
779,1001,997,4,SCHWARZ,1003,0,3,760,0,664.471937,0.159840,0.039960,0.001994
780,997,1005,8,ROT,995,1,25,802,0,664.631778,0.770311,0.080241,0.016048
781,1005,1006,1,ROT,994,1,9,803,0,665.402089,0.011940,0.009950,0.001990
782,1006,1007,1,ROT,993,1,23,804,0,665.414029,0.011928,0.009940,0.001988
783,1007,1006,1,ROT,994,0,20,680,0,665.425957,0.009930,0.009930,0.001988
784,1006,1008,2,SCHWARZ,992,1,4,644,0,665.435888,0.047714,0.019881,0.003976
785,1008,1007,1,SCHWARZ,993,0,12,761,0,665.483602,0.009921,0.009921,0.003976
786,1007,1009,2,ROT,991,1,21,806,0,665.493522,0.047666,0.019861,0.003972
787,1009,1008,1,ROT,992,0,24,681,0,665.541188,0.009911,0.009911,0.003972
788,1008,1006,2,SCHWARZ,994,0,16,763,0,665.551099,0.039683,0.019841,0.003972
789,1006,1010,4,ROT,990,1,7,810,0,665.590782,0.190855,0.039761,0.007952
790,1010,1009,1,ROT,991,0,13,682,0,665.781637,0.009901,0.009901,0.007952
791,1009,1007,2,SCHWARZ,993,0,19,765,0,665.791538,0.039643,0.019822,0.007952
792,1007,1011,4,ROT,989,1,14,814,0,665.831181,0.190665,0.039722,0.007944
793,1011,1010,1,ROT,990,0,22,683,0,666.021846,0.009891,0.009891,0.007944
794,1010,1008,2,SCHWARZ,992,0,12,767,0,666.031737,0.039604,0.019802,0.007944
795,1008,1004,4,ROT,996,0,35,687,0,666.071341,0.158730,0.039683,0.007944
796,1004,1012,8,SCHWARZ,988,1,4,652,0,666.230072,0.764940,0.079681,0.015936
797,1012,1013,1,SCHWARZ,987,1,35,653,0,666.995012,0.011858,0.009881,0.001976
798,1013,1012,1,SCHWARZ,988,0,30,768,0,667.006869,0.009872,0.009872,0.001976
799,1012,1010,2,ROT,990,0,15,689,0,667.016741,0.039526,0.019763,0.001976
800,1010,1014,4,SCHWARZ,986,1,13,657,0,667.056267,0.190099,0.039604,0.007921
801,1014,1013,1,SCHWARZ,987,0,1,769,0,667.246366,0.009862,0.009862,0.007921
802,1013,1011,2,ROT,989,0,2,691,0,667.256228,0.039487,0.019743,0.007921
803,1011,1007,4,SCHWARZ,993,0,7,773,0,667.295714,0.158259,0.039565,0.007921
804,1007,999,8,ROT,1001,0,28,699,0,667.453974,0.635551,0.079444,0.007921
805,999,1015,16,SCHWARZ,985,1,15,673,0,668.089525,3.075075,0.160160,0.032032
806,1015,1016,1,SCHWARZ,984,1,26,674,0,671.164600,0.011823,0.009852,0.001970
807,1016,1017,1,SCHWARZ,983,1,31,675,0,671.176423,0.011811,0.009843,0.001969
808,1017,1016,1,SCHWARZ,984,0,0,774,0,671.188234,0.009833,0.009833,0.001969
809,1016,1018,2,ROT,982,1,34,816,0,671.198066,0.047244,0.019685,0.003937
810,1018,1017,1,ROT,983,0,4,700,0,671.245310,0.009823,0.009823,0.003937
811,1017,1015,2,SCHWARZ,985,0,27,776,0,671.255134,0.039331,0.019666,0.003937
812,1015,1011,4,ROT,989,0,2,704,0,671.294465,0.157635,0.039409,0.003937
813,1011,1019,8,SCHWARZ,981,1,33,683,0,671.452100,0.759644,0.079130,0.015826
814,1019,1018,1,SCHWARZ,982,0,27,777,0,672.211744,0.009814,0.009814,0.015826
815,1018,1020,2,ROT,980,1,21,818,0,672.221558,0.047151,0.019646,0.003929
816,1020,1019,1,ROT,981,0,33,705,0,672.268709,0.009804,0.009804,0.003929
817,1019,1021,2,SCHWARZ,979,1,2,685,0,672.278513,0.047105,0.019627,0.003925
818,1021,1020,1,SCHWARZ,980,0,9,778,0,672.325618,0.009794,0.009794,0.003925
819,1020,1018,2,ROT,982,0,33,707,0,672.335412,0.039216,0.019608,0.003925
820,1018,1022,4,SCHWARZ,978,1,6,689,0,672.374628,0.188605,0.039293,0.007859
821,1022,1021,1,SCHWARZ,979,0,32,779,0,672.563233,0.009785,0.009785,0.007859
822,1021,1019,2,ROT,981,0,29,709,0,672.573018,0.039177,0.019589,0.007859
823,1019,1015,4,SCHWARZ,985,0,19,783,0,672.612195,0.157017,0.039254,0.007859
824,1015,1023,8,ROT,977,1,19,826,0,672.769212,0.756650,0.078818,0.015764
825,1023,1024,1,ROT,976,1,25,827,0,673.525862,0.011730,0.009775,0.001955
826,1024,1023,1,ROT,977,0,10,710,0,673.537592,0.009766,0.009766,0.001955
827,1023,1021,2,SCHWARZ,979,0,16,785,0,673.547358,0.039101,0.019550,0.001955
828,1021,1017,4,ROT,983,0,0,714,0,673.586459,0.156709,0.039177,0.001955
829,1017,1025,8,SCHWARZ,975,1,20,697,0,673.743168,0.755162,0.078663,0.015733
830,1025,1024,1,SCHWARZ,976,0,18,786,0,674.498330,0.009756,0.009756,0.015733
831,1024,1022,2,ROT,978,0,26,716,0,674.508086,0.039062,0.019531,0.015733
832,1022,1018,4,SCHWARZ,982,0,34,790,0,674.547149,0.156556,0.039139,0.015733
833,1018,1026,8,ROT,974,1,5,835,0,674.703704,0.754420,0.078585,0.015717
834,1026,1025,1,ROT,975,0,0,717,0,675.458125,0.009747,0.009747,0.015717
835,1025,1023,2,SCHWARZ,977,0,34,792,0,675.467871,0.039024,0.019512,0.015717
836,1023,1019,4,ROT,981,0,35,721,0,675.506896,0.156403,0.039101,0.015717
837,1019,1027,8,SCHWARZ,973,1,4,705,0,675.663299,0.753680,0.078508,0.015702
838,1027,1028,1,SCHWARZ,972,1,28,706,0,676.416979,0.011685,0.009737,0.001947
839,1028,1029,1,SCHWARZ,971,1,26,707,0,676.428663,0.011673,0.009728,0.001946
840,1029,1030,1,SCHWARZ,970,1,31,708,0,676.440336,0.011662,0.009718,0.001944
841,1030,1031,1,SCHWARZ,969,1,2,709,0,676.451998,0.011650,0.009709,0.001942
842,1031,1032,1,SCHWARZ,968,1,24,710,0,676.463649,0.011639,0.009699,0.001940
843,1032,1031,1,SCHWARZ,969,0,25,793,0,676.475288,0.009690,0.009690,0.001940
844,1031,1033,2,ROT,967,1,9,837,0,676.484978,0.046557,0.019399,0.003880
845,1033,1034,1,ROT,966,1,14,838,0,676.531534,0.011617,0.009681,0.001936
846,1034,1035,1,ROT,965,1,18,839,0,676.543151,0.011605,0.009671,0.001934
847,1035,1034,1,ROT,966,0,2,722,0,676.554757,0.009662,0.009662,0.001934
848,1034,1032,2,SCHWARZ,968,0,12,795,0,676.564418,0.038685,0.019342,0.001934
849,1032,1036,4,ROT,964,1,25,843,0,676.603103,0.186047,0.038760,0.007752
850,1036,1035,1,ROT,965,0,2,723,0,676.789150,0.009653,0.009653,0.007752
851,1035,1033,2,SCHWARZ,967,0,21,797,0,676.798802,0.038647,0.019324,0.007752
852,1033,1037,4,ROT,963,1,16,847,0,676.837449,0.185866,0.038722,0.007744
853,1037,1038,1,ROT,962,1,34,848,0,677.023316,0.011572,0.009643,0.001929
854,1038,1039,1,ROT,961,1,23,849,0,677.034888,0.011561,0.009634,0.001927
855,1039,1040,1,ROT,960,1,34,850,0,677.046448,0.011550,0.009625,0.001925
856,1040,1039,1,ROT,961,0,11,724,0,677.057998,0.009615,0.009615,0.001925
857,1039,1041,2,SCHWARZ,959,1,8,712,0,677.067613,0.046198,0.019249,0.003850
858,1041,1040,1,SCHWARZ,960,0,27,798,0,677.113812,0.009606,0.009606,0.003850
859,1040,1038,2,ROT,962,0,8,726,0,677.123418,0.038462,0.019231,0.003850
860,1038,1042,4,SCHWARZ,958,1,8,716,0,677.161879,0.184971,0.038536,0.007707
861,1042,1041,1,SCHWARZ,959,0,16,799,0,677.346850,0.009597,0.009597,0.007707
862,1041,1043,2,ROT,957,1,36,852,0,677.356447,0.046110,0.019212,0.003842
863,1043,1042,1,ROT,958,0,0,727,0,677.402557,0.009588,0.009588,0.003842
864,1042,1040,2,SCHWARZ,960,0,7,801,0,677.412145,0.038388,0.019194,0.003842
865,1040,1044,4,ROT,956,1,27,856,0,677.450532,0.184615,0.038462,0.007692
866,1044,1043,1,ROT,957,0,35,728,0,677.635148,0.009579,0.009579,0.007692
867,1043,1041,2,SCHWARZ,959,0,25,803,0,677.644726,0.038351,0.019175,0.007692
868,1041,1045,4,ROT,955,1,34,860,0,677.683077,0.184438,0.038425,0.007685
869,1045,1044,1,ROT,956,0,13,729,0,677.867515,0.009569,0.009569,0.007685
870,1044,1046,2,SCHWARZ,954,1,10,718,0,677.877085,0.045977,0.019157,0.003831
871,1046,1047,1,SCHWARZ,953,1,24,719,0,677.923062,0.011472,0.009560,0.001912
872,1047,1048,1,SCHWARZ,952,1,24,720,0,677.934534,0.011461,0.009551,0.001910
873,1048,1047,1,SCHWARZ,953,0,19,804,0,677.945995,0.009542,0.009542,0.001910
874,1047,1045,2,ROT,955,0,15,731,0,677.955537,0.038204,0.019102,0.001910
875,1045,1049,4,SCHWARZ,951,1,20,724,0,677.993742,0.183732,0.038278,0.007656
876,1049,1048,1,SCHWARZ,952,0,5,805,0,678.177474,0.009533,0.009533,0.007656
877,1048,1046,2,ROT,954,0,33,733,0,678.187006,0.038168,0.019084,0.007656
878,1046,1042,4,SCHWARZ,958,0,18,809,0,678.225174,0.152964,0.038241,0.007656
879,1042,1050,8,ROT,950,1,5,868,0,678.378138,0.737044,0.076775,0.015355
880,1050,1049,1,ROT,951,0,17,734,0,679.115182,0.009524,0.009524,0.015355
881,1049,1047,2,SCHWARZ,953,0,1,811,0,679.124706,0.038132,0.019066,0.015355
882,1047,1051,4,ROT,949,1,30,872,0,679.162838,0.183381,0.038204,0.007641
883,1051,1050,1,ROT,950,0,8,735,0,679.346219,0.009515,0.009515,0.007641
884,1050,1048,2,SCHWARZ,952,0,19,813,0,679.355733,0.038095,0.019048,0.007641
885,1048,1052,4,ROT,948,1,14,876,0,679.393829,0.183206,0.038168,0.007634
886,1052,1051,1,ROT,949,0,35,736,0,679.577035,0.009506,0.009506,0.007634
887,1051,1049,2,SCHWARZ,951,0,23,815,0,679.586541,0.038059,0.019029,0.007634
888,1049,1053,4,ROT,947,1,23,880,0,679.624599,0.183031,0.038132,0.007626
889,1053,1054,1,ROT,946,1,34,881,0,679.807631,0.011396,0.009497,0.001899
890,1054,1055,1,ROT,945,1,19,882,0,679.819027,0.011385,0.009488,0.001898
891,1055,1056,1,ROT,944,1,9,883,0,679.830412,0.011374,0.009479,0.001896
892,1056,1057,1,ROT,943,1,36,884,0,679.841787,0.011364,0.009470,0.001894
893,1057,1058,1,ROT,942,1,21,885,0,679.853150,0.011353,0.009461,0.001892
894,1058,1057,1,ROT,943,0,24,737,0,679.864503,0.009452,0.009452,0.001892
895,1057,1055,2,SCHWARZ,945,0,34,817,0,679.873955,0.037843,0.018921,0.001892
896,1055,1051,4,ROT,949,0,15,741,0,679.911798,0.151659,0.037915,0.001892
897,1051,1043,8,SCHWARZ,957,0,23,825,0,680.063457,0.608944,0.076118,0.001892
898,1043,1059,16,ROT,941,1,27,901,0,680.672400,2.945350,0.153404,0.030681
899,1059,1060,1,ROT,940,1,19,902,0,683.617750,0.011331,0.009443,0.001889
900,1060,1061,1,ROT,939,1,23,903,0,683.629082,0.011321,0.009434,0.001887
901,1061,1062,1,ROT,938,1,25,904,0,683.640403,0.011310,0.009425,0.001885
902,1062,1061,1,ROT,939,0,22,742,0,683.651713,0.009416,0.009416,0.001885
903,1061,1059,2,SCHWARZ,941,0,23,827,0,683.661129,0.037700,0.018850,0.001885
904,1059,1055,4,ROT,945,0,13,746,0,683.698829,0.151086,0.037771,0.001885
905,1055,1047,8,SCHWARZ,953,0,32,835,0,683.849915,0.606635,0.075829,0.001885
906,1047,1063,16,ROT,937,1,36,920,0,684.456550,2.934097,0.152818,0.030564
907,1063,1064,1,ROT,936,1,25,921,0,687.390648,0.011289,0.009407,0.001881
908,1064,1065,1,ROT,935,1,19,922,0,687.401936,0.011278,0.009398,0.001880
909,1065,1064,1,ROT,936,0,6,747,0,687.413215,0.009390,0.009390,0.001880
910,1064,1066,2,SCHWARZ,934,1,13,726,0,687.422604,0.045113,0.018797,0.003759
911,1066,1067,1,SCHWARZ,933,1,2,727,0,687.467717,0.011257,0.009381,0.001876
912,1067,1068,1,SCHWARZ,932,1,2,728,0,687.478974,0.011246,0.009372,0.001874
913,1068,1069,1,SCHWARZ,931,1,8,729,0,687.490221,0.011236,0.009363,0.001873
914,1069,1070,1,SCHWARZ,930,1,28,730,0,687.501457,0.011225,0.009355,0.001871
915,1070,1069,1,SCHWARZ,931,0,7,836,0,687.512682,0.009346,0.009346,0.001871
916,1069,1067,2,ROT,933,0,22,749,0,687.522028,0.037418,0.018709,0.001871
917,1067,1071,4,SCHWARZ,929,1,4,734,0,687.559446,0.179944,0.037488,0.007498
918,1071,1072,1,SCHWARZ,928,1,11,735,0,687.739390,0.011204,0.009337,0.001867
919,1072,1073,1,SCHWARZ,927,1,8,736,0,687.750594,0.011194,0.009328,0.001866
920,1073,1072,1,SCHWARZ,928,0,23,837,0,687.761788,0.009320,0.009320,0.001866
921,1072,1074,2,ROT,926,1,34,924,0,687.771108,0.044776,0.018657,0.003731
922,1074,1075,1,ROT,925,1,3,925,0,687.815884,0.011173,0.009311,0.001862
923,1075,1074,1,ROT,926,0,6,750,0,687.827057,0.009302,0.009302,0.001862
924,1074,1072,2,SCHWARZ,928,0,1,839,0,687.836360,0.037244,0.018622,0.001862
925,1072,1068,4,ROT,932,0,28,754,0,687.873603,0.149254,0.037313,0.001862
926,1068,1076,8,SCHWARZ,924,1,29,744,0,688.022857,0.719101,0.074906,0.014981
927,1076,1075,1,SCHWARZ,925,0,16,840,0,688.741958,0.009294,0.009294,0.014981
928,1075,1073,2,ROT,927,0,13,756,0,688.751252,0.037209,0.018605,0.014981
929,1073,1069,4,SCHWARZ,931,0,32,844,0,688.788461,0.149115,0.037279,0.014981
930,1069,1061,8,ROT,939,0,29,764,0,688.937576,0.598690,0.074836,0.014981
931,1061,1045,16,SCHWARZ,955,0,30,860,0,689.536266,2.412818,0.150801,0.014981
932,1045,1077,32,ROT,923,1,7,957,0,691.949084,11.758852,0.306220,0.061244
933,1077,1076,1,ROT,924,0,31,765,0,703.707936,0.009285,0.009285,0.061244
934,1076,1074,2,SCHWARZ,926,0,19,862,0,703.717221,0.037175,0.018587,0.061244
935,1074,1070,4,ROT,930,0,6,769,0,703.754396,0.148976,0.037244,0.061244
936,1070,1062,8,SCHWARZ,938,0,19,870,0,703.903372,0.598131,0.074766,0.061244
937,1062,1046,16,ROT,954,0,4,785,0,704.501503,2.410546,0.150659,0.061244
938,1046,1078,32,SCHWARZ,922,1,20,776,0,706.912049,11.747610,0.305927,0.061185
939,1078,1079,1,SCHWARZ,921,1,6,777,0,718.659659,0.011132,0.009276,0.001855
940,1079,1080,1,SCHWARZ,920,1,33,778,0,718.670790,0.011121,0.009268,0.001854
941,1080,1079,1,SCHWARZ,921,0,3,871,0,718.681912,0.009259,0.009259,0.001854
942,1079,1081,2,ROT,919,1,23,959,0,718.691171,0.044486,0.018536,0.003707
943,1081,1080,1,ROT,920,0,2,786,0,718.735657,0.009251,0.009251,0.003707
944,1080,1078,2,SCHWARZ,922,0,23,873,0,718.744907,0.037037,0.018519,0.003707
945,1078,1082,4,ROT,918,1,16,963,0,718.781944,0.178108,0.037106,0.007421
946,1082,1083,1,ROT,917,1,18,964,0,718.960052,0.011091,0.009242,0.001848
947,1083,1082,1,ROT,918,0,6,787,0,718.971143,0.009234,0.009234,0.001848
948,1082,1080,2,SCHWARZ,920,0,3,875,0,718.980376,0.036969,0.018484,0.001848
949,1080,1084,4,ROT,916,1,34,968,0,719.017345,0.177778,0.037037,0.007407
950,1084,1083,1,ROT,917,0,35,788,0,719.195123,0.009225,0.009225,0.007407
951,1083,1085,2,SCHWARZ,915,1,15,780,0,719.204348,0.044321,0.018467,0.003693
952,1085,1084,1,SCHWARZ,916,0,7,876,0,719.248669,0.009217,0.009217,0.003693
953,1084,1086,2,ROT,914,1,12,970,0,719.257886,0.044280,0.018450,0.003690
954,1086,1085,1,ROT,915,0,17,789,0,719.302166,0.009208,0.009208,0.003690
955,1085,1087,2,SCHWARZ,913,1,13,782,0,719.311374,0.044240,0.018433,0.003687
956,1087,1088,1,SCHWARZ,912,1,29,783,0,719.355614,0.011040,0.009200,0.001840
957,1088,1087,1,SCHWARZ,913,0,9,877,0,719.366653,0.009191,0.009191,0.001840
958,1087,1089,2,ROT,911,1,1,972,0,719.375844,0.044158,0.018399,0.003680
959,1089,1088,1,ROT,912,0,33,790,0,719.420003,0.009183,0.009183,0.003680
960,1088,1090,2,SCHWARZ,910,1,13,785,0,719.429185,0.044118,0.018382,0.003676
961,1090,1091,1,SCHWARZ,909,1,10,786,0,719.473303,0.011009,0.009174,0.001835
962,1091,1090,1,SCHWARZ,910,0,0,878,0,719.484312,0.009166,0.009166,0.001835
963,1090,1092,2,ROT,908,1,7,974,0,719.493478,0.044037,0.018349,0.003670
964,1092,1091,1,ROT,909,0,17,791,0,719.537515,0.009158,0.009158,0.003670
965,1091,1093,2,SCHWARZ,907,1,6,788,0,719.546672,0.043996,0.018332,0.003666
966,1093,1092,1,SCHWARZ,908,0,27,879,0,719.590669,0.009149,0.009149,0.003666
967,1092,1090,2,ROT,910,0,10,793,0,719.599818,0.036630,0.018315,0.003666
968,1090,1086,4,SCHWARZ,914,0,5,883,0,719.636448,0.146789,0.036697,0.003666
969,1086,1078,8,ROT,922,0,13,801,0,719.783237,0.589319,0.073665,0.003666
970,1078,1094,16,SCHWARZ,906,1,31,804,0,720.372555,2.849722,0.148423,0.029685
971,1094,1095,1,SCHWARZ,905,1,15,805,0,723.222277,0.010969,0.009141,0.001828
972,1095,1094,1,SCHWARZ,906,0,23,884,0,723.233246,0.009132,0.009132,0.001828
973,1094,1092,2,ROT,908,0,20,803,0,723.242378,0.036563,0.018282,0.001828
974,1092,1088,4,SCHWARZ,912,0,9,888,0,723.278942,0.146520,0.036630,0.001828
975,1088,1080,8,ROT,920,0,22,811,0,723.425462,0.588235,0.073529,0.001828
976,1080,1064,16,SCHWARZ,936,0,21,904,0,724.013697,2.370370,0.148148,0.001828
977,1064,1096,32,ROT,904,1,5,1006,0,726.384067,11.548872,0.300752,0.060150
978,1096,1095,1,ROT,905,0,2,812,0,737.932940,0.009124,0.009124,0.060150
979,1095,1097,2,SCHWARZ,903,1,4,807,0,737.942064,0.043836,0.018265,0.003653
980,1097,1098,1,SCHWARZ,902,1,2,808,0,737.985899,0.010939,0.009116,0.001823
981,1098,1099,1,SCHWARZ,901,1,33,809,0,737.996838,0.010929,0.009107,0.001821
982,1099,1098,1,SCHWARZ,902,0,25,905,0,738.007767,0.009099,0.009099,0.001821
983,1098,1100,2,ROT,900,1,5,1008,0,738.016866,0.043716,0.018215,0.003643
984,1100,1099,1,ROT,901,0,13,813,0,738.060582,0.009091,0.009091,0.003643
985,1099,1101,2,SCHWARZ,899,1,17,811,0,738.069673,0.043676,0.018198,0.003640
986,1101,1102,1,SCHWARZ,898,1,17,812,0,738.113349,0.010899,0.009083,0.001817
987,1102,1103,1,SCHWARZ,897,1,6,813,0,738.124248,0.010889,0.009074,0.001815
988,1103,1102,1,SCHWARZ,898,0,5,906,0,738.135138,0.009066,0.009066,0.001815
989,1102,1104,2,ROT,896,1,7,1010,0,738.144204,0.043557,0.018149,0.003630
990,1104,1105,1,ROT,895,1,34,1011,0,738.187761,0.010870,0.009058,0.001812
991,1105,1104,1,ROT,896,0,22,814,0,738.198631,0.009050,0.009050,0.001812
992,1104,1102,2,SCHWARZ,898,0,0,908,0,738.207680,0.036232,0.018116,0.001812
993,1102,1106,4,ROT,894,1,32,1015,0,738.243912,0.174229,0.036298,0.007260
994,1106,1105,1,ROT,895,0,24,815,0,738.418141,0.009042,0.009042,0.007260
995,1105,1107,2,SCHWARZ,893,1,2,815,0,738.427182,0.043439,0.018100,0.003620
996,1107,1108,1,SCHWARZ,892,1,24,816,0,738.470621,0.010840,0.009033,0.001807
997,1108,1109,1,SCHWARZ,891,1,4,817,0,738.481462,0.010830,0.009025,0.001805
998,1109,1108,1,SCHWARZ,892,0,23,909,0,738.492292,0.009017,0.009017,0.001805
999,1108,1106,2,ROT,894,0,20,817,0,738.501309,0.036101,0.018051,0.001805
1000,1106,1102,4,SCHWARZ,898,0,27,913,0,738.537410,0.144665,0.036166,0.001805
1001,1102,1094,8,ROT,906,0,33,825,0,738.682076,0.580762,0.072595,0.001805
1002,1094,1110,16,SCHWARZ,890,1,26,833,0,739.262838,2.808044,0.146252,0.029250
1003,1110,1111,1,SCHWARZ,889,1,11,834,0,742.070882,0.010811,0.009009,0.001802
1004,1111,1110,1,SCHWARZ,890,0,7,914,0,742.081692,0.009001,0.009001,0.001802
1005,1110,1108,2,ROT,892,0,28,827,0,742.090693,0.036036,0.018018,0.001802
1006,1108,1104,4,SCHWARZ,896,0,32,918,0,742.126729,0.144404,0.036101,0.001802
1007,1104,1096,8,ROT,904,0,17,835,0,742.271134,0.579710,0.072464,0.001802
1008,1096,1112,16,SCHWARZ,888,1,20,850,0,742.850844,2.802920,0.145985,0.029197
1009,1112,1111,1,SCHWARZ,889,0,30,919,0,745.653764,0.008993,0.008993,0.029197
1010,1111,1109,2,ROT,891,0,13,837,0,745.662756,0.036004,0.018002,0.029197
1011,1109,1105,4,SCHWARZ,895,0,36,923,0,745.698760,0.144274,0.036069,0.029197
1012,1105,1097,8,ROT,903,0,35,845,0,745.843034,0.579186,0.072398,0.029197
1013,1097,1113,16,SCHWARZ,887,1,35,866,0,746.422220,2.800365,0.145852,0.029170
1014,1113,1112,1,SCHWARZ,888,0,23,924,0,749.222584,0.008985,0.008985,0.029170
1015,1112,1114,2,ROT,886,1,32,1017,0,749.231569,0.043165,0.017986,0.003597
1016,1114,1115,1,ROT,885,1,32,1018,0,749.274734,0.010772,0.008977,0.001795
1017,1115,1114,1,ROT,886,0,13,846,0,749.285506,0.008969,0.008969,0.001795
1018,1114,1116,2,SCHWARZ,884,1,2,868,0,749.294475,0.043088,0.017953,0.003591
1019,1116,1117,1,SCHWARZ,883,1,35,869,0,749.337563,0.010753,0.008961,0.001792
1020,1117,1116,1,SCHWARZ,884,0,7,925,0,749.348316,0.008953,0.008953,0.001792
1021,1116,1118,2,ROT,882,1,9,1020,0,749.357268,0.043011,0.017921,0.003584
1022,1118,1117,1,ROT,883,0,24,847,0,749.400279,0.008945,0.008945,0.003584
1023,1117,1115,2,SCHWARZ,885,0,27,927,0,749.409224,0.035810,0.017905,0.003584
1024,1115,1119,4,ROT,881,1,30,1024,0,749.445034,0.172197,0.035874,0.007175
1025,1119,1120,1,ROT,880,1,9,1025,0,749.617231,0.010724,0.008937,0.001787
1026,1120,1121,1,ROT,879,1,18,1026,0,749.627955,0.010714,0.008929,0.001786
1027,1121,1122,1,ROT,878,1,23,1027,0,749.638669,0.010705,0.008921,0.001784
1028,1122,1121,1,ROT,879,0,4,848,0,749.649374,0.008913,0.008913,0.001784
1029,1121,1123,2,SCHWARZ,877,1,11,871,0,749.658287,0.042819,0.017841,0.003568
1030,1123,1124,1,SCHWARZ,876,1,35,872,0,749.701106,0.010686,0.008905,0.001781
1031,1124,1123,1,SCHWARZ,877,0,25,928,0,749.711791,0.008897,0.008897,0.001781
1032,1123,1121,2,ROT,879,0,28,850,0,749.720688,0.035619,0.017809,0.001781
1033,1121,1125,4,SCHWARZ,875,1,10,876,0,749.756307,0.171276,0.035682,0.007136
1034,1125,1126,1,SCHWARZ,874,1,4,877,0,749.927583,0.010667,0.008889,0.001778
1035,1126,1127,1,SCHWARZ,873,1,17,878,0,749.938249,0.010657,0.008881,0.001776
1036,1127,1128,1,SCHWARZ,872,1,26,879,0,749.948906,0.010648,0.008873,0.001775
1037,1128,1129,1,SCHWARZ,871,1,13,880,0,749.959554,0.010638,0.008865,0.001773
1038,1129,1128,1,SCHWARZ,872,0,18,929,0,749.970192,0.008857,0.008857,0.001773
1039,1128,1126,2,ROT,874,0,35,852,0,749.979050,0.035461,0.017730,0.001773
1040,1126,1130,4,SCHWARZ,870,1,31,884,0,750.014511,0.170515,0.035524,0.007105
1041,1130,1129,1,SCHWARZ,871,0,7,930,0,750.185026,0.008850,0.008850,0.007105
1042,1129,1127,2,ROT,873,0,11,854,0,750.193875,0.035430,0.017715,0.007105
1043,1127,1123,4,SCHWARZ,877,0,19,934,0,750.229305,0.141970,0.035492,0.007105
1044,1123,1131,8,ROT,869,1,21,1035,0,750.371275,0.683882,0.071238,0.014248
1045,1131,1130,1,ROT,870,0,6,855,0,751.055157,0.008842,0.008842,0.014248
1046,1130,1132,2,SCHWARZ,868,1,22,886,0,751.063999,0.042478,0.017699,0.003540
1047,1132,1131,1,SCHWARZ,869,0,18,935,0,751.106477,0.008834,0.008834,0.003540
1048,1131,1133,2,ROT,867,1,14,1037,0,751.115311,0.042440,0.017683,0.003537
1049,1133,1134,1,ROT,866,1,32,1038,0,751.157751,0.010591,0.008826,0.001765
1050,1134,1135,1,ROT,865,1,16,1039,0,751.168343,0.010582,0.008818,0.001764
1051,1135,1134,1,ROT,866,0,29,856,0,751.178925,0.008811,0.008811,0.001764
1052,1134,1132,2,SCHWARZ,868,0,27,937,0,751.187735,0.035273,0.017637,0.001764
1053,1132,1128,4,ROT,872,0,10,860,0,751.223008,0.141343,0.035336,0.001764
1054,1128,1136,8,SCHWARZ,864,1,33,894,0,751.364351,0.680851,0.070922,0.014184
1055,1136,1137,1,SCHWARZ,863,1,35,895,0,752.045202,0.010563,0.008803,0.001761
1056,1137,1136,1,SCHWARZ,864,0,32,938,0,752.055766,0.008795,0.008795,0.001761
1057,1136,1134,2,ROT,866,0,20,862,0,752.064561,0.035211,0.017606,0.001761
1058,1134,1130,4,SCHWARZ,870,0,34,942,0,752.099772,0.141093,0.035273,0.001761
1059,1130,1138,8,ROT,862,1,14,1047,0,752.240866,0.679646,0.070796,0.014159
1060,1138,1137,1,ROT,863,0,8,863,0,752.920512,0.008787,0.008787,0.014159
1061,1137,1135,2,SCHWARZ,865,0,23,944,0,752.929299,0.035180,0.017590,0.014159
1062,1135,1131,4,ROT,869,0,31,867,0,752.964479,0.140969,0.035242,0.014159
1063,1131,1139,8,SCHWARZ,861,1,22,903,0,753.105448,0.679045,0.070734,0.014147
1064,1139,1140,1,SCHWARZ,860,1,33,904,0,753.784493,0.010536,0.008780,0.001756
1065,1140,1141,1,SCHWARZ,859,1,6,905,0,753.795029,0.010526,0.008772,0.001754
1066,1141,1142,1,SCHWARZ,858,1,20,906,0,753.805555,0.010517,0.008764,0.001753
1067,1142,1143,1,SCHWARZ,857,1,28,907,0,753.816072,0.010508,0.008757,0.001751
1068,1143,1144,1,SCHWARZ,856,1,24,908,0,753.826580,0.010499,0.008749,0.001750
1069,1144,1145,1,SCHWARZ,855,1,26,909,0,753.837079,0.010490,0.008741,0.001748
1070,1145,1144,1,SCHWARZ,856,0,21,945,0,753.847568,0.008734,0.008734,0.001748
1071,1144,1142,2,ROT,858,0,15,869,0,753.856302,0.034965,0.017483,0.001748
1072,1142,1138,4,SCHWARZ,862,0,9,949,0,753.891267,0.140105,0.035026,0.001748
1073,1138,1146,8,ROT,854,1,18,1055,0,754.031372,0.674868,0.070299,0.014060
1074,1146,1145,1,ROT,855,0,24,870,0,754.706240,0.008726,0.008726,0.014060
1075,1145,1143,2,SCHWARZ,857,0,9,951,0,754.714966,0.034934,0.017467,0.014060
1076,1143,1139,4,ROT,861,0,24,874,0,754.749901,0.139983,0.034996,0.014060
1077,1139,1131,8,SCHWARZ,869,0,14,959,0,754.889883,0.561896,0.070237,0.014060
1078,1131,1147,16,ROT,853,1,12,1071,0,755.451780,2.716180,0.141468,0.028294
1079,1147,1148,1,ROT,852,1,1,1072,0,758.167960,0.010462,0.008718,0.001744
1080,1148,1149,1,ROT,851,1,16,1073,0,758.178422,0.010453,0.008711,0.001742
1081,1149,1150,1,ROT,850,1,7,1074,0,758.188875,0.010444,0.008703,0.001741
1082,1150,1151,1,ROT,849,1,14,1075,0,758.199319,0.010435,0.008696,0.001739
1083,1151,1150,1,ROT,850,0,8,875,0,758.209754,0.008688,0.008688,0.001739
1084,1150,1148,2,SCHWARZ,852,0,34,961,0,758.218442,0.034783,0.017391,0.001739
1085,1148,1152,4,ROT,848,1,30,1079,0,758.253225,0.167247,0.034843,0.006969
1086,1152,1153,1,ROT,847,1,3,1080,0,758.420472,0.010417,0.008681,0.001736
1087,1153,1152,1,ROT,848,0,35,876,0,758.430889,0.008673,0.008673,0.001736
1088,1152,1150,2,SCHWARZ,850,0,19,963,0,758.439562,0.034722,0.017361,0.001736
1089,1150,1146,4,ROT,854,0,17,880,0,758.474284,0.139130,0.034783,0.001736
1090,1146,1154,8,SCHWARZ,846,1,15,917,0,758.613414,0.670157,0.069808,0.013962
1091,1154,1155,1,SCHWARZ,845,1,17,918,0,759.283571,0.010399,0.008666,0.001733
1092,1155,1154,1,SCHWARZ,846,0,19,964,0,759.293970,0.008658,0.008658,0.001733
1093,1154,1156,2,ROT,844,1,30,1082,0,759.302628,0.041594,0.017331,0.003466
1094,1156,1157,1,ROT,843,1,25,1083,0,759.344222,0.010381,0.008651,0.001730
1095,1157,1158,1,ROT,842,1,23,1084,0,759.354603,0.010372,0.008643,0.001729
1096,1158,1159,1,ROT,841,1,7,1085,0,759.364975,0.010363,0.008636,0.001727
1097,1159,1160,1,ROT,840,1,21,1086,0,759.375337,0.010354,0.008628,0.001726
1098,1160,1159,1,ROT,841,0,26,881,0,759.385691,0.008621,0.008621,0.001726
1099,1159,1157,2,SCHWARZ,843,0,1,966,0,759.394312,0.034513,0.017256,0.001726
1100,1157,1153,4,ROT,847,0,17,885,0,759.428824,0.138289,0.034572,0.001726
1101,1153,1161,8,SCHWARZ,839,1,20,926,0,759.567113,0.666088,0.069384,0.013877
1102,1161,1162,1,SCHWARZ,838,1,24,927,0,760.233202,0.010336,0.008613,0.001723
1103,1162,1161,1,SCHWARZ,839,0,12,967,0,760.243537,0.008606,0.008606,0.001723
1104,1161,1163,2,ROT,837,1,27,1088,0,760.252143,0.041344,0.017227,0.003445
1105,1163,1162,1,ROT,838,0,11,886,0,760.293487,0.008598,0.008598,0.003445
1106,1162,1164,2,SCHWARZ,836,1,8,929,0,760.302085,0.041308,0.017212,0.003442
1107,1164,1163,1,SCHWARZ,837,0,36,968,0,760.343394,0.008591,0.008591,0.003442
1108,1163,1165,2,ROT,835,1,5,1090,0,760.351985,0.041273,0.017197,0.003439
1109,1165,1164,1,ROT,836,0,22,887,0,760.393257,0.008584,0.008584,0.003439
1110,1164,1162,2,SCHWARZ,838,0,30,970,0,760.401841,0.034364,0.017182,0.003439
1111,1162,1166,4,ROT,834,1,27,1094,0,760.436205,0.165232,0.034423,0.006885
1112,1166,1165,1,ROT,835,0,20,888,0,760.601437,0.008576,0.008576,0.006885
1113,1165,1163,2,SCHWARZ,837,0,36,972,0,760.610014,0.034335,0.017167,0.006885
1114,1163,1167,4,ROT,833,1,23,1098,0,760.644349,0.165090,0.034394,0.006879
1115,1167,1166,1,ROT,834,0,11,889,0,760.809439,0.008569,0.008569,0.006879
1116,1166,1168,2,SCHWARZ,832,1,17,931,0,760.818008,0.041166,0.017153,0.003431
1117,1168,1167,1,SCHWARZ,833,0,25,973,0,760.859174,0.008562,0.008562,0.003431
1118,1167,1165,2,ROT,835,0,2,891,0,760.867736,0.034276,0.017138,0.003431
1119,1165,1169,4,SCHWARZ,831,1,11,935,0,760.902012,0.164807,0.034335,0.006867
1120,1169,1170,1,SCHWARZ,830,1,10,936,0,761.066819,0.010265,0.008554,0.001711
1121,1170,1169,1,SCHWARZ,831,0,25,974,0,761.077084,0.008547,0.008547,0.001711
1122,1169,1171,2,ROT,829,1,7,1100,0,761.085631,0.041061,0.017109,0.003422
1123,1171,1172,1,ROT,828,1,14,1101,0,761.126692,0.010248,0.008540,0.001708
1124,1172,1171,1,ROT,829,0,11,892,0,761.136939,0.008532,0.008532,0.001708
1125,1171,1169,2,SCHWARZ,831,0,12,976,0,761.145472,0.034159,0.017079,0.001708
1126,1169,1165,4,ROT,835,0,28,896,0,761.179630,0.136869,0.034217,0.001708
1127,1165,1173,8,SCHWARZ,827,1,20,944,0,761.316500,0.659227,0.068670,0.013734
1128,1173,1172,1,SCHWARZ,828,0,21,977,0,761.975727,0.008525,0.008525,0.013734
1129,1172,1174,2,ROT,826,1,14,1103,0,761.984252,0.040956,0.017065,0.003413
1130,1174,1173,1,ROT,827,0,31,897,0,762.025208,0.008518,0.008518,0.003413
1131,1173,1175,2,SCHWARZ,825,1,15,946,0,762.033726,0.040921,0.017050,0.003410
1132,1175,1174,1,SCHWARZ,826,0,14,978,0,762.074646,0.008511,0.008511,0.003410
1133,1174,1172,2,ROT,828,0,26,899,0,762.083157,0.034072,0.017036,0.003410
1134,1172,1176,4,SCHWARZ,824,1,28,950,0,762.117229,0.163823,0.034130,0.006826
1135,1176,1175,1,SCHWARZ,825,0,36,979,0,762.281051,0.008503,0.008503,0.006826
1136,1175,1177,2,ROT,823,1,36,1105,0,762.289555,0.040851,0.017021,0.003404
1137,1177,1178,1,ROT,822,1,27,1106,0,762.330406,0.010195,0.008496,0.001699
1138,1178,1177,1,ROT,823,0,26,900,0,762.340601,0.008489,0.008489,0.001699
1139,1177,1175,2,SCHWARZ,825,0,21,981,0,762.349090,0.033985,0.016992,0.001699
1140,1175,1179,4,ROT,821,1,12,1110,0,762.383075,0.163404,0.034043,0.006809
1141,1179,1178,1,ROT,822,0,26,901,0,762.546479,0.008482,0.008482,0.006809
1142,1178,1176,2,SCHWARZ,824,0,23,983,0,762.554961,0.033956,0.016978,0.006809
1143,1176,1180,4,ROT,820,1,7,1114,0,762.588917,0.163265,0.034014,0.006803
1144,1180,1179,1,ROT,821,0,24,902,0,762.752182,0.008475,0.008475,0.006803
1145,1179,1177,2,SCHWARZ,823,0,27,985,0,762.760656,0.033927,0.016964,0.006803
1146,1177,1181,4,ROT,819,1,7,1118,0,762.794584,0.163127,0.033985,0.006797
1147,1181,1182,1,ROT,818,1,5,1119,0,762.957710,0.010161,0.008467,0.001693
1148,1182,1181,1,ROT,819,0,33,903,0,762.967871,0.008460,0.008460,0.001693
1149,1181,1183,2,SCHWARZ,817,1,24,952,0,762.976331,0.040644,0.016935,0.003387
1150,1183,1182,1,SCHWARZ,818,0,30,986,0,763.016975,0.008453,0.008453,0.003387
1151,1182,1184,2,ROT,816,1,14,1121,0,763.025428,0.040609,0.016920,0.003384
1152,1184,1183,1,ROT,817,0,4,904,0,763.066037,0.008446,0.008446,0.003384
1153,1183,1185,2,SCHWARZ,815,1,4,954,0,763.074483,0.040575,0.016906,0.003381
1154,1185,1184,1,SCHWARZ,816,0,0,987,0,763.115058,0.008439,0.008439,0.003381
1155,1184,1186,2,ROT,814,1,21,1123,0,763.123497,0.040541,0.016892,0.003378
1156,1186,1185,1,ROT,815,0,6,905,0,763.164037,0.008432,0.008432,0.003378
1157,1185,1183,2,SCHWARZ,817,0,36,989,0,763.172469,0.033755,0.016878,0.003378
1158,1183,1187,4,ROT,813,1,25,1127,0,763.206224,0.162299,0.033812,0.006762
1159,1187,1186,1,ROT,814,0,13,906,0,763.368523,0.008425,0.008425,0.006762
1160,1186,1184,2,SCHWARZ,816,0,7,991,0,763.376948,0.033727,0.016863,0.006762
1161,1184,1180,4,ROT,820,0,13,910,0,763.410675,0.135135,0.033784,0.006762
1162,1180,1188,8,SCHWARZ,812,1,20,962,0,763.545810,0.650847,0.067797,0.013559
1163,1188,1189,1,SCHWARZ,811,1,8,963,0,764.196657,0.010101,0.008418,0.001684
1164,1189,1188,1,SCHWARZ,812,0,27,992,0,764.206758,0.008410,0.008410,0.001684
1165,1188,1186,2,ROT,814,0,35,912,0,764.215169,0.033670,0.016835,0.001684
1166,1186,1190,4,SCHWARZ,810,1,13,967,0,764.248839,0.161889,0.033727,0.006745
1167,1190,1189,1,SCHWARZ,811,0,5,993,0,764.410727,0.008403,0.008403,0.006745
1168,1189,1191,2,ROT,809,1,14,1129,0,764.419131,0.040370,0.016821,0.003364
1169,1191,1190,1,ROT,810,0,24,913,0,764.459501,0.008396,0.008396,0.003364
1170,1190,1188,2,SCHWARZ,812,0,0,995,0,764.467897,0.033613,0.016807,0.003364
1171,1188,1192,4,ROT,808,1,12,1133,0,764.501511,0.161616,0.033670,0.006734
1172,1192,1191,1,ROT,809,0,8,914,0,764.663127,0.008389,0.008389,0.006734
1173,1191,1193,2,SCHWARZ,807,1,8,969,0,764.671516,0.040302,0.016793,0.003359
1174,1193,1192,1,SCHWARZ,808,0,36,996,0,764.711818,0.008382,0.008382,0.003359
1175,1192,1190,2,ROT,810,0,0,916,0,764.720201,0.033557,0.016779,0.003359
1176,1190,1186,4,SCHWARZ,814,0,21,1000,0,764.753758,0.134454,0.033613,0.003359
1177,1186,1194,8,ROT,806,1,25,1141,0,764.888211,0.647555,0.067454,0.013491
1178,1194,1193,1,ROT,807,0,26,917,0,765.535766,0.008375,0.008375,0.013491
1179,1193,1191,2,SCHWARZ,809,0,16,1002,0,765.544141,0.033529,0.016764,0.013491
1180,1191,1195,4,ROT,805,1,32,1145,0,765.577670,0.161209,0.033585,0.006717
1181,1195,1196,1,ROT,804,1,9,1146,0,765.738879,0.010042,0.008368,0.001674
1182,1196,1197,1,ROT,803,1,16,1147,0,765.748921,0.010033,0.008361,0.001672
1183,1197,1196,1,ROT,804,0,13,918,0,765.758955,0.008354,0.008354,0.001672
1184,1196,1194,2,SCHWARZ,806,0,21,1004,0,765.767309,0.033445,0.016722,0.001672
1185,1194,1190,4,ROT,810,0,13,922,0,765.800754,0.134003,0.033501,0.001672
1186,1190,1182,8,SCHWARZ,818,0,1,1012,0,765.934757,0.537815,0.067227,0.001672
1187,1182,1198,16,ROT,802,1,32,1163,0,766.472572,2.598985,0.135364,0.027073
1188,1198,1199,1,ROT,801,1,9,1164,0,769.071557,0.010017,0.008347,0.001669
1189,1199,1198,1,ROT,802,0,11,923,0,769.081574,0.008340,0.008340,0.001669
1190,1198,1196,2,SCHWARZ,804,0,36,1014,0,769.089914,0.033389,0.016694,0.001669
1191,1196,1200,4,ROT,800,1,5,1168,0,769.123303,0.160535,0.033445,0.006689
1192,1200,1201,1,ROT,799,1,9,1169,0,769.283838,0.010000,0.008333,0.001667
1193,1201,1202,1,ROT,798,1,5,1170,0,769.293838,0.009992,0.008326,0.001665
1194,1202,1203,1,ROT,797,1,3,1171,0,769.303830,0.009983,0.008319,0.001664
1195,1203,1202,1,ROT,798,0,6,924,0,769.313813,0.008313,0.008313,0.001664
1196,1202,1204,2,SCHWARZ,796,1,33,971,0,769.322126,0.039933,0.016639,0.003328
1197,1204,1205,1,SCHWARZ,795,1,22,972,0,769.362059,0.009967,0.008306,0.001661
1198,1205,1204,1,SCHWARZ,796,0,27,1015,0,769.372026,0.008299,0.008299,0.001661
1199,1204,1202,2,ROT,798,0,6,926,0,769.380325,0.033223,0.016611,0.001661
1200,1202,1206,4,SCHWARZ,794,1,8,976,0,769.413547,0.159734,0.033278,0.006656
1201,1206,1207,1,SCHWARZ,793,1,10,977,0,769.573281,0.009950,0.008292,0.001658
1202,1207,1206,1,SCHWARZ,794,0,27,1016,0,769.583231,0.008285,0.008285,0.001658
1203,1206,1204,2,ROT,796,0,15,928,0,769.591516,0.033167,0.016584,0.001658
1204,1204,1208,4,SCHWARZ,792,1,20,981,0,769.624684,0.159468,0.033223,0.006645
1205,1208,1207,1,SCHWARZ,793,0,25,1017,0,769.784152,0.008278,0.008278,0.006645
1206,1207,1205,2,ROT,795,0,26,930,0,769.792430,0.033140,0.016570,0.006645
1207,1205,1201,4,SCHWARZ,799,0,7,1021,0,769.825570,0.132780,0.033195,0.006645
1208,1201,1209,8,ROT,791,1,25,1179,0,769.958350,0.639467,0.066611,0.013322
1209,1209,1210,1,ROT,790,1,36,1180,0,770.597818,0.009926,0.008271,0.001654
1210,1210,1209,1,ROT,791,0,35,931,0,770.607743,0.008264,0.008264,0.001654
1211,1209,1207,2,SCHWARZ,793,0,0,1023,0,770.616008,0.033085,0.016543,0.001654
1212,1207,1211,4,ROT,789,1,5,1184,0,770.649093,0.159072,0.033140,0.006628
1213,1211,1210,1,ROT,790,0,24,932,0,770.808165,0.008258,0.008258,0.006628
1214,1210,1212,2,SCHWARZ,788,1,13,983,0,770.816422,0.039669,0.016529,0.003306
1215,1212,1211,1,SCHWARZ,789,0,0,1024,0,770.856092,0.008251,0.008251,0.003306
1216,1211,1213,2,ROT,787,1,18,1186,0,770.864343,0.039637,0.016515,0.003303
1217,1213,1214,1,ROT,786,1,5,1187,0,770.903979,0.009893,0.008244,0.001649
1218,1214,1215,1,ROT,785,1,32,1188,0,770.913872,0.009885,0.008237,0.001647
1219,1215,1214,1,ROT,786,0,8,933,0,770.923757,0.008230,0.008230,0.001647
1220,1214,1216,2,SCHWARZ,784,1,31,985,0,770.931987,0.039539,0.016474,0.003295
1221,1216,1215,1,SCHWARZ,785,0,12,1025,0,770.971526,0.008224,0.008224,0.003295
1222,1215,1213,2,ROT,787,0,17,935,0,770.979750,0.032922,0.016461,0.003295
1223,1213,1209,4,SCHWARZ,791,0,36,1029,0,771.012672,0.131904,0.032976,0.003295
1224,1209,1201,8,ROT,799,0,20,943,0,771.144576,0.529363,0.066170,0.003295
1225,1201,1185,16,SCHWARZ,815,0,9,1045,0,771.673939,2.131557,0.133222,0.003295
1226,1185,1217,32,ROT,783,1,32,1220,0,773.805496,10.369620,0.270042,0.054008
1227,1217,1218,1,ROT,782,1,3,1221,0,784.175116,0.009860,0.008217,0.001643
1228,1218,1217,1,ROT,783,0,2,944,0,784.184977,0.008210,0.008210,0.001643
1229,1217,1215,2,SCHWARZ,785,0,23,1047,0,784.193187,0.032868,0.016434,0.001643
1230,1215,1211,4,ROT,789,0,22,948,0,784.226055,0.131687,0.032922,0.001643
1231,1211,1203,8,SCHWARZ,797,0,27,1055,0,784.357742,0.528489,0.066061,0.001643
1232,1203,1219,16,ROT,781,1,19,1237,0,784.886231,2.553616,0.133001,0.026600
1233,1219,1218,1,ROT,782,0,8,949,0,787.439847,0.008203,0.008203,0.026600
1234,1218,1216,2,SCHWARZ,784,0,7,1057,0,787.448050,0.032841,0.016420,0.026600
1235,1216,1212,4,ROT,788,0,17,953,0,787.480891,0.131579,0.032895,0.026600
1236,1212,1204,8,SCHWARZ,796,0,25,1065,0,787.612470,0.528053,0.066007,0.026600
1237,1204,1188,16,ROT,812,0,2,969,0,788.140523,2.126246,0.132890,0.026600
1238,1188,1156,32,SCHWARZ,844,0,12,1097,0,790.266768,8.619529,0.269360,0.026600
1239,1156,1092,64,ROT,908,0,2,1033,0,798.886297,35.432526,0.553633,0.026600
1240,1092,1091,1,SCHWARZ,909,0,3,1098,0,834.318823,0.009158,0.009158,0.026600
1241,1091,1093,2,ROT,907,1,7,1239,0,834.327980,0.043996,0.018332,0.003666
1242,1093,1092,1,ROT,908,0,33,1034,0,834.371977,0.009149,0.009149,0.003666
1243,1092,1094,2,SCHWARZ,906,1,33,987,0,834.381126,0.043956,0.018315,0.003663
1244,1094,1093,1,SCHWARZ,907,0,34,1099,0,834.425082,0.009141,0.009141,0.003663
1245,1093,1091,2,ROT,909,0,15,1036,0,834.434223,0.036597,0.018298,0.003663
1246,1091,1095,4,SCHWARZ,905,1,26,991,0,834.470819,0.175985,0.036664,0.007333
1247,1095,1094,1,SCHWARZ,906,0,7,1100,0,834.646805,0.009132,0.009132,0.007333
1248,1094,1096,2,ROT,904,1,7,1241,0,834.655937,0.043876,0.018282,0.003656
1249,1096,1097,1,ROT,903,1,19,1242,0,834.699813,0.010949,0.009124,0.001825
1250,1097,1098,1,ROT,902,1,27,1243,0,834.710762,0.010939,0.009116,0.001823
1251,1098,1099,1,ROT,901,1,3,1244,0,834.721701,0.010929,0.009107,0.001821
1252,1099,1100,1,ROT,900,1,25,1245,0,834.732629,0.010919,0.009099,0.001820
1253,1100,1099,1,ROT,901,0,13,1037,0,834.743549,0.009091,0.009091,0.001820
1254,1099,1101,2,SCHWARZ,899,1,20,993,0,834.752639,0.043676,0.018198,0.003640
1255,1101,1100,1,SCHWARZ,900,0,7,1101,0,834.796315,0.009083,0.009083,0.003640
1256,1100,1102,2,ROT,898,1,21,1247,0,834.805398,0.043636,0.018182,0.003636
1257,1102,1103,1,ROT,897,1,12,1248,0,834.849035,0.010889,0.009074,0.001815
1258,1103,1104,1,ROT,896,1,1,1249,0,834.859924,0.010879,0.009066,0.001813
1259,1104,1105,1,ROT,895,1,14,1250,0,834.870803,0.010870,0.009058,0.001812
1260,1105,1106,1,ROT,894,1,30,1251,0,834.881673,0.010860,0.009050,0.001810
1261,1106,1105,1,ROT,895,0,4,1038,0,834.892533,0.009042,0.009042,0.001810
1262,1105,1103,2,SCHWARZ,897,0,5,1103,0,834.901574,0.036199,0.018100,0.001810
1263,1103,1107,4,ROT,893,1,1,1255,0,834.937773,0.174071,0.036265,0.007253
1264,1107,1106,1,ROT,894,0,2,1039,0,835.111844,0.009033,0.009033,0.007253
1265,1106,1104,2,SCHWARZ,896,0,34,1105,0,835.120877,0.036166,0.018083,0.007253
1266,1104,1108,4,ROT,892,1,27,1259,0,835.157044,0.173913,0.036232,0.007246
1267,1108,1109,1,ROT,891,1,1,1260,0,835.330957,0.010830,0.009025,0.001805
1268,1109,1110,1,ROT,890,1,34,1261,0,835.341787,0.010821,0.009017,0.001803
1269,1110,1111,1,ROT,889,1,18,1262,0,835.352608,0.010811,0.009009,0.001802
1270,1111,1112,1,ROT,888,1,16,1263,0,835.363418,0.010801,0.009001,0.001800
1271,1112,1111,1,ROT,889,0,4,1040,0,835.374220,0.008993,0.008993,0.001800
1272,1111,1113,2,SCHWARZ,887,1,35,995,0,835.383212,0.043204,0.018002,0.003600
1273,1113,1112,1,SCHWARZ,888,0,0,1106,0,835.426417,0.008985,0.008985,0.003600
1274,1112,1110,2,ROT,890,0,15,1042,0,835.435401,0.035971,0.017986,0.003600
1275,1110,1106,4,SCHWARZ,894,0,21,1110,0,835.471373,0.144144,0.036036,0.003600
1276,1106,1098,8,ROT,902,0,31,1050,0,835.615517,0.578662,0.072333,0.003600
1277,1098,1082,16,SCHWARZ,918,0,19,1126,0,836.194179,2.331512,0.145719,0.003600
1278,1082,1050,32,ROT,950,0,17,1082,0,838.525690,9.463956,0.295749,0.003600
1279,1050,986,64,SCHWARZ,1014,0,14,1190,0,847.989646,39.009524,0.609524,0.003600
1280,986,987,1,ROT,1013,1,9,1264,0,886.999170,0.012170,0.010142,0.002028
1281,987,988,1,ROT,1012,1,16,1265,0,887.011340,0.012158,0.010132,0.002026
1282,988,989,1,ROT,1011,1,5,1266,0,887.023498,0.012146,0.010121,0.002024
1283,989,988,1,ROT,1012,0,17,1083,0,887.035644,0.010111,0.010111,0.002024
1284,988,990,2,SCHWARZ,1010,1,17,997,0,887.045755,0.048583,0.020243,0.004049
1285,990,991,1,SCHWARZ,1009,1,10,998,0,887.094338,0.012121,0.010101,0.002020
1286,991,992,1,SCHWARZ,1008,1,20,999,0,887.106459,0.012109,0.010091,0.002018
1287,992,993,1,SCHWARZ,1007,1,4,1000,0,887.118568,0.012097,0.010081,0.002016
1288,993,994,1,SCHWARZ,1006,1,15,1001,0,887.130665,0.012085,0.010070,0.002014
1289,994,995,1,SCHWARZ,1005,1,28,1002,0,887.142750,0.012072,0.010060,0.002012
1290,995,994,1,SCHWARZ,1006,0,1,1191,0,887.154822,0.010050,0.010050,0.002012
1291,994,992,2,ROT,1008,0,10,1085,0,887.164873,0.040241,0.020121,0.002012
1292,992,988,4,SCHWARZ,1012,0,0,1195,0,887.205114,0.161290,0.040323,0.002012
1293,988,996,8,ROT,1004,1,19,1274,0,887.366404,0.777328,0.080972,0.016194
1294,996,997,1,ROT,1003,1,14,1275,0,888.143732,0.012048,0.010040,0.002008
1295,997,996,1,ROT,1004,0,29,1086,0,888.155780,0.010030,0.010030,0.002008
1296,996,994,2,SCHWARZ,1006,0,36,1197,0,888.165811,0.040161,0.020080,0.002008
1297,994,990,4,ROT,1010,0,15,1090,0,888.205971,0.160966,0.040241,0.002008
1298,990,982,8,SCHWARZ,1018,0,18,1205,0,888.366937,0.646465,0.080808,0.002008
1299,982,998,16,ROT,1002,1,27,1291,0,889.013402,3.128310,0.162933,0.032587
1300,998,997,1,ROT,1003,0,22,1091,0,892.141711,0.010020,0.010020,0.032587
1301,997,995,2,SCHWARZ,1005,0,19,1207,0,892.151731,0.040120,0.020060,0.032587
1302,995,999,4,ROT,1001,1,19,1295,0,892.191852,0.192965,0.040201,0.008040
1303,999,998,1,ROT,1002,0,15,1092,0,892.384816,0.010010,0.010010,0.008040
1304,998,996,2,SCHWARZ,1004,0,21,1209,0,892.394826,0.040080,0.020040,0.008040
1305,996,992,4,ROT,1008,0,4,1096,0,892.434907,0.160643,0.040161,0.008040
1306,992,1000,8,SCHWARZ,1000,1,8,1010,0,892.595549,0.774194,0.080645,0.016129
1307,1000,1001,1,SCHWARZ,999,1,29,1011,0,893.369743,0.012000,0.010000,0.002000
1308,1001,1000,1,SCHWARZ,1000,0,30,1210,0,893.381743,0.009990,0.009990,0.002000
1309,1000,1002,2,ROT,998,1,19,1297,0,893.391733,0.048000,0.020000,0.004000
1310,1002,1003,1,ROT,997,1,36,1298,0,893.439733,0.011976,0.009980,0.001996
1311,1003,1002,1,ROT,998,0,13,1097,0,893.451709,0.009970,0.009970,0.001996
1312,1002,1004,2,SCHWARZ,996,1,11,1013,0,893.461679,0.047904,0.019960,0.003992
1313,1004,1005,1,SCHWARZ,995,1,24,1014,0,893.509583,0.011952,0.009960,0.001992
1314,1005,1006,1,SCHWARZ,994,1,28,1015,0,893.521535,0.011940,0.009950,0.001990
1315,1006,1005,1,SCHWARZ,995,0,32,1211,0,893.533476,0.009940,0.009940,0.001990
1316,1005,1007,2,ROT,993,1,1,1300,0,893.543416,0.047761,0.019900,0.003980
1317,1007,1008,1,ROT,992,1,9,1301,0,893.591177,0.011917,0.009930,0.001986
1318,1008,1009,1,ROT,991,1,14,1302,0,893.603094,0.011905,0.009921,0.001984
1319,1009,1010,1,ROT,990,1,32,1303,0,893.614998,0.011893,0.009911,0.001982
1320,1010,1011,1,ROT,989,1,19,1304,0,893.626891,0.011881,0.009901,0.001980
1321,1011,1010,1,ROT,990,0,22,1098,0,893.638773,0.009891,0.009891,0.001980
1322,1010,1012,2,SCHWARZ,988,1,8,1017,0,893.648664,0.047525,0.019802,0.003960
1323,1012,1011,1,SCHWARZ,989,0,9,1212,0,893.696189,0.009881,0.009881,0.003960
1324,1011,1009,2,ROT,991,0,17,1100,0,893.706070,0.039565,0.019782,0.003960
1325,1009,1005,4,SCHWARZ,995,0,14,1216,0,893.745635,0.158573,0.039643,0.003960
1326,1005,1013,8,ROT,987,1,18,1312,0,893.904208,0.764179,0.079602,0.015920
1327,1013,1012,1,ROT,988,0,6,1101,0,894.668387,0.009872,0.009872,0.015920
1328,1012,1014,2,SCHWARZ,986,1,6,1019,0,894.678258,0.047431,0.019763,0.003953
1329,1014,1013,1,SCHWARZ,987,0,21,1217,0,894.725689,0.009862,0.009862,0.003953
1330,1013,1011,2,ROT,989,0,24,1103,0,894.735551,0.039487,0.019743,0.003953
1331,1011,1015,4,SCHWARZ,985,1,33,1023,0,894.775038,0.189911,0.039565,0.007913
1332,1015,1016,1,SCHWARZ,984,1,10,1024,0,894.964949,0.011823,0.009852,0.001970
1333,1016,1017,1,SCHWARZ,983,1,4,1025,0,894.976771,0.011811,0.009843,0.001969
1334,1017,1016,1,SCHWARZ,984,0,36,1218,0,894.988582,0.009833,0.009833,0.001969
1335,1016,1018,2,ROT,982,1,9,1314,0,894.998415,0.047244,0.019685,0.003937
1336,1018,1017,1,ROT,983,0,15,1104,0,895.045659,0.009823,0.009823,0.003937
1337,1017,1019,2,SCHWARZ,981,1,2,1027,0,895.055483,0.047198,0.019666,0.003933
1338,1019,1020,1,SCHWARZ,980,1,8,1028,0,895.102680,0.011776,0.009814,0.001963
1339,1020,1019,1,SCHWARZ,981,0,9,1219,0,895.114456,0.009804,0.009804,0.001963
1340,1019,1021,2,ROT,979,1,30,1316,0,895.124260,0.047105,0.019627,0.003925
1341,1021,1020,1,ROT,980,0,11,1105,0,895.171365,0.009794,0.009794,0.003925
1342,1020,1018,2,SCHWARZ,982,0,1,1221,0,895.181160,0.039216,0.019608,0.003925
1343,1018,1014,4,ROT,986,0,31,1109,0,895.220375,0.157171,0.039293,0.003925
1344,1014,1022,8,SCHWARZ,978,1,13,1036,0,895.377546,0.757396,0.078895,0.015779
1345,1022,1021,1,SCHWARZ,979,0,12,1222,0,896.134943,0.009785,0.009785,0.015779
1346,1021,1019,2,ROT,981,0,8,1111,0,896.144728,0.039177,0.019589,0.015779
1347,1019,1023,4,SCHWARZ,977,1,2,1040,0,896.183905,0.188420,0.039254,0.007851
1348,1023,1024,1,SCHWARZ,976,1,31,1041,0,896.372325,0.011730,0.009775,0.001955
1349,1024,1025,1,SCHWARZ,975,1,17,1042,0,896.384055,0.011719,0.009766,0.001953
1350,1025,1024,1,SCHWARZ,976,0,16,1223,0,896.395774,0.009756,0.009756,0.001953
1351,1024,1022,2,ROT,978,0,35,1113,0,896.405530,0.039062,0.019531,0.001953
1352,1022,1026,4,SCHWARZ,974,1,20,1046,0,896.444592,0.187867,0.039139,0.007828
1353,1026,1025,1,SCHWARZ,975,0,30,1224,0,896.632459,0.009747,0.009747,0.007828
1354,1025,1027,2,ROT,973,1,19,1318,0,896.642206,0.046829,0.019512,0.003902
1355,1027,1026,1,ROT,974,0,33,1114,0,896.689035,0.009737,0.009737,0.003902
1356,1026,1028,2,SCHWARZ,972,1,15,1048,0,896.698772,0.046784,0.019493,0.003899
1357,1028,1029,1,SCHWARZ,971,1,29,1049,0,896.745556,0.011673,0.009728,0.001946
1358,1029,1030,1,SCHWARZ,970,1,26,1050,0,896.757229,0.011662,0.009718,0.001944
1359,1030,1031,1,SCHWARZ,969,1,35,1051,0,896.768891,0.011650,0.009709,0.001942
1360,1031,1030,1,SCHWARZ,970,0,16,1225,0,896.780541,0.009699,0.009699,0.001942
1361,1030,1032,2,ROT,968,1,3,1320,0,896.790241,0.046602,0.019417,0.003883
1362,1032,1031,1,ROT,969,0,17,1115,0,896.836843,0.009690,0.009690,0.003883
1363,1031,1033,2,SCHWARZ,967,1,33,1053,0,896.846533,0.046557,0.019399,0.003880
1364,1033,1032,1,SCHWARZ,968,0,5,1226,0,896.893089,0.009681,0.009681,0.003880
1365,1032,1034,2,ROT,966,1,23,1322,0,896.902770,0.046512,0.019380,0.003876
1366,1034,1033,1,ROT,967,0,0,1116,0,896.949281,0.009671,0.009671,0.003876
1367,1033,1031,2,SCHWARZ,969,0,16,1228,0,896.958953,0.038722,0.019361,0.003876
1368,1031,1027,4,ROT,973,0,20,1120,0,896.997675,0.155189,0.038797,0.003876
1369,1027,1019,8,SCHWARZ,981,0,3,1236,0,897.152864,0.623174,0.077897,0.003876
1370,1019,1003,16,ROT,997,0,35,1136,0,897.776038,2.512267,0.157017,0.003876
1371,1003,971,32,SCHWARZ,1029,0,12,1268,0,900.288305,10.209372,0.319043,0.003876
1372,971,1035,64,ROT,965,1,1,1386,0,910.497677,50.619980,0.659114,0.131823
1373,1035,1036,1,ROT,964,1,34,1387,0,961.117657,0.011594,0.009662,0.001932
1374,1036,1035,1,ROT,965,0,31,1137,0,961.129251,0.009653,0.009653,0.001932
1375,1035,1037,2,SCHWARZ,963,1,35,1055,0,961.138903,0.046377,0.019324,0.003865
1376,1037,1038,1,SCHWARZ,962,1,22,1056,0,961.185280,0.011572,0.009643,0.001929
1377,1038,1039,1,SCHWARZ,961,1,22,1057,0,961.196852,0.011561,0.009634,0.001927
1378,1039,1038,1,SCHWARZ,962,0,27,1269,0,961.208413,0.009625,0.009625,0.001927
1379,1038,1040,2,ROT,960,1,30,1389,0,961.218037,0.046243,0.019268,0.003854
1380,1040,1039,1,ROT,961,0,10,1138,0,961.264280,0.009615,0.009615,0.003854
1381,1039,1037,2,SCHWARZ,963,0,27,1271,0,961.273895,0.038499,0.019249,0.003854
1382,1037,1041,4,ROT,959,1,14,1393,0,961.312394,0.185149,0.038573,0.007715
1383,1041,1040,1,ROT,960,0,33,1139,0,961.497543,0.009606,0.009606,0.007715
1384,1040,1038,2,SCHWARZ,962,0,25,1273,0,961.507150,0.038462,0.019231,0.007715
1385,1038,1042,4,ROT,958,1,36,1397,0,961.545611,0.184971,0.038536,0.007707
1386,1042,1041,1,ROT,959,0,10,1140,0,961.730582,0.009597,0.009597,0.007707
1387,1041,1039,2,SCHWARZ,961,0,25,1275,0,961.740179,0.038425,0.019212,0.007707
1388,1039,1035,4,ROT,965,0,13,1144,0,961.778604,0.153994,0.038499,0.007707
1389,1035,1043,8,SCHWARZ,957,1,31,1065,0,961.932598,0.742029,0.077295,0.015459
1390,1043,1042,1,SCHWARZ,958,0,25,1276,0,962.674627,0.009588,0.009588,0.015459
1391,1042,1040,2,ROT,960,0,15,1146,0,962.684215,0.038388,0.019194,0.015459
1392,1040,1036,4,SCHWARZ,964,0,21,1280,0,962.722602,0.153846,0.038462,0.015459
1393,1036,1044,8,ROT,956,1,34,1405,0,962.876449,0.741313,0.077220,0.015444
1394,1044,1043,1,ROT,957,0,20,1147,0,963.617761,0.009579,0.009579,0.015444
1395,1043,1045,2,SCHWARZ,955,1,10,1067,0,963.627340,0.046021,0.019175,0.003835
1396,1045,1046,1,SCHWARZ,954,1,31,1068,0,963.673361,0.011483,0.009569,0.001914
1397,1046,1047,1,SCHWARZ,953,1,8,1069,0,963.684844,0.011472,0.009560,0.001912
1398,1047,1048,1,SCHWARZ,952,1,31,1070,0,963.696316,0.011461,0.009551,0.001910
1399,1048,1047,1,SCHWARZ,953,0,23,1281,0,963.707778,0.009542,0.009542,0.001910
1400,1047,1045,2,ROT,955,0,33,1149,0,963.717320,0.038204,0.019102,0.001910
1401,1045,1041,4,SCHWARZ,959,0,5,1285,0,963.755524,0.153110,0.038278,0.001910
1402,1041,1033,8,ROT,967,0,31,1157,0,963.908634,0.614793,0.076849,0.001910
1403,1033,1017,16,SCHWARZ,983,0,7,1301,0,964.523428,2.478219,0.154889,0.001910
1404,1017,1049,32,ROT,951,1,32,1437,0,967.001646,12.082596,0.314651,0.062930
1405,1049,1048,1,ROT,952,0,29,1158,0,979.084242,0.009533,0.009533,0.062930
1406,1048,1046,2,SCHWARZ,954,0,12,1303,0,979.093775,0.038168,0.019084,0.062930
1407,1046,1042,4,ROT,958,0,29,1162,0,979.131943,0.152964,0.038241,0.062930
1408,1042,1034,8,SCHWARZ,966,0,19,1311,0,979.284907,0.614203,0.076775,0.062930
1409,1034,1018,16,ROT,982,0,33,1178,0,979.899110,2.475822,0.154739,0.062930
1410,1018,1050,32,SCHWARZ,950,1,10,1102,0,982.374932,12.070727,0.314342,0.062868
1411,1050,1051,1,SCHWARZ,949,1,11,1103,0,994.445659,0.011429,0.009524,0.001905
1412,1051,1052,1,SCHWARZ,948,1,31,1104,0,994.457088,0.011418,0.009515,0.001903
1413,1052,1051,1,SCHWARZ,949,0,5,1312,0,994.468506,0.009506,0.009506,0.001903
1414,1051,1049,2,ROT,951,0,2,1180,0,994.478011,0.038059,0.019029,0.001903
1415,1049,1045,4,SCHWARZ,955,0,14,1316,0,994.516070,0.152526,0.038132,0.001903
1416,1045,1037,8,ROT,963,0,33,1188,0,994.668596,0.612440,0.076555,0.001903
1417,1037,1021,16,SCHWARZ,979,0,21,1332,0,995.281037,2.468660,0.154291,0.001903
1418,1021,989,32,ROT,1011,0,26,1220,0,997.749696,10.029383,0.313418,0.001903
1419,989,925,64,SCHWARZ,1075,0,30,1396,1,7.779079,41.415571,0.647118,0.001903
1420,925,924,1,ROT,1076,0,15,1221,1,49.194650,0.010811,0.010811,0.001903
1421,924,922,2,SCHWARZ,1078,0,23,1398,1,49.205461,0.043290,0.021645,0.001903
1422,922,918,4,ROT,1082,0,20,1225,1,49.248751,0.173536,0.043384,0.001903
1423,918,910,8,SCHWARZ,1090,0,16,1406,1,49.422287,0.697168,0.087146,0.001903
1424,910,926,16,ROT,1074,1,7,1453,1,50.119455,3.375824,0.175824,0.035165
1425,926,925,1,ROT,1075,0,29,1226,1,53.495279,0.010799,0.010799,0.035165
1426,925,927,2,SCHWARZ,1073,1,22,1106,1,53.506078,0.051892,0.021622,0.004324
1427,927,928,1,SCHWARZ,1072,1,2,1107,1,53.557970,0.012945,0.010787,0.002157
1428,928,927,1,SCHWARZ,1073,0,3,1407,1,53.570915,0.010776,0.010776,0.002157
1429,927,929,2,ROT,1071,1,3,1455,1,53.581691,0.051780,0.021575,0.004315
1430,929,930,1,ROT,1070,1,9,1456,1,53.633471,0.012917,0.010764,0.002153
1431,930,931,1,ROT,1069,1,18,1457,1,53.646388,0.012903,0.010753,0.002151
1432,931,930,1,ROT,1070,0,35,1227,1,53.659291,0.010741,0.010741,0.002151
1433,930,932,2,SCHWARZ,1068,1,10,1109,1,53.670032,0.051613,0.021505,0.004301
1434,932,931,1,SCHWARZ,1069,0,14,1408,1,53.721645,0.010730,0.010730,0.004301
1435,931,929,2,ROT,1071,0,11,1229,1,53.732375,0.042965,0.021482,0.004301
1436,929,933,4,SCHWARZ,1067,1,15,1113,1,53.775339,0.206674,0.043057,0.008611
1437,933,932,1,SCHWARZ,1068,0,7,1409,1,53.982013,0.010718,0.010718,0.008611
1438,932,930,2,ROT,1070,0,22,1231,1,53.992731,0.042918,0.021459,0.008611
1439,930,934,4,SCHWARZ,1066,1,31,1117,1,54.035650,0.206452,0.043011,0.008602
1440,934,933,1,SCHWARZ,1067,0,0,1410,1,54.242101,0.010707,0.010707,0.008602
1441,933,935,2,ROT,1065,1,34,1459,1,54.252808,0.051447,0.021436,0.004287
1442,935,934,1,ROT,1066,0,10,1232,1,54.304255,0.010695,0.010695,0.004287
1443,934,936,2,SCHWARZ,1064,1,28,1119,1,54.314950,0.051392,0.021413,0.004283
1444,936,937,1,SCHWARZ,1063,1,11,1120,1,54.366342,0.012821,0.010684,0.002137
1445,937,936,1,SCHWARZ,1064,0,21,1411,1,54.379163,0.010672,0.010672,0.002137
1446,936,938,2,ROT,1062,1,12,1461,1,54.389835,0.051282,0.021368,0.004274
1447,938,939,1,ROT,1061,1,36,1462,1,54.441117,0.012793,0.010661,0.002132
1448,939,940,1,ROT,1060,1,5,1463,1,54.453910,0.012780,0.010650,0.002130
1449,940,939,1,ROT,1061,0,33,1233,1,54.466690,0.010638,0.010638,0.002130
1450,939,941,2,SCHWARZ,1059,1,29,1122,1,54.477328,0.051118,0.021299,0.004260
1451,941,942,1,SCHWARZ,1058,1,33,1123,1,54.528446,0.012752,0.010627,0.002125
1452,942,941,1,SCHWARZ,1059,0,34,1412,1,54.541199,0.010616,0.010616,0.002125
1453,941,939,2,ROT,1061,0,6,1235,1,54.551814,0.042508,0.021254,0.002125
1454,939,943,4,SCHWARZ,1057,1,17,1127,1,54.594322,0.204473,0.042599,0.008520
1455,943,942,1,SCHWARZ,1058,0,18,1413,1,54.798795,0.010604,0.010604,0.008520
1456,942,940,2,ROT,1060,0,22,1237,1,54.809400,0.042463,0.021231,0.008520
1457,940,936,4,SCHWARZ,1064,0,27,1417,1,54.851862,0.170213,0.042553,0.008520
1458,936,928,8,ROT,1072,0,33,1245,1,55.022075,0.683761,0.085470,0.008520
1459,928,944,16,SCHWARZ,1056,1,20,1143,1,55.705836,3.310345,0.172414,0.034483
1460,944,943,1,SCHWARZ,1057,0,5,1418,1,59.016181,0.010593,0.010593,0.034483
1461,943,941,2,ROT,1059,0,6,1247,1,59.026774,0.042418,0.021209,0.034483
1462,941,937,4,SCHWARZ,1063,0,27,1422,1,59.069192,0.170032,0.042508,0.034483
1463,937,945,8,ROT,1055,1,32,1471,1,59.239224,0.819637,0.085379,0.017076
1464,945,944,1,ROT,1056,0,15,1248,1,60.058861,0.010582,0.010582,0.017076
1465,944,942,2,SCHWARZ,1058,0,3,1424,1,60.069443,0.042373,0.021186,0.017076
1466,942,938,4,ROT,1062,0,35,1252,1,60.111816,0.169851,0.042463,0.017076
1467,938,930,8,SCHWARZ,1070,0,0,1432,1,60.281667,0.682303,0.085288,0.017076
1468,930,946,16,ROT,1054,1,27,1487,1,60.963970,3.303226,0.172043,0.034409
1469,946,947,1,ROT,1053,1,19,1488,1,64.267196,0.012685,0.010571,0.002114
1470,947,946,1,ROT,1054,0,24,1253,1,64.279881,0.010560,0.010560,0.002114
1471,946,944,2,SCHWARZ,1056,0,9,1434,1,64.290440,0.042283,0.021142,0.002114
1472,944,948,4,ROT,1052,1,32,1492,1,64.332724,0.203390,0.042373,0.008475
1473,948,949,1,ROT,1051,1,1,1493,1,64.536113,0.012658,0.010549,0.002110
1474,949,950,1,ROT,1050,1,21,1494,1,64.548772,0.012645,0.010537,0.002107
1475,950,951,1,ROT,1049,1,14,1495,1,64.561417,0.012632,0.010526,0.002105
1476,951,952,1,ROT,1048,1,7,1496,1,64.574048,0.012618,0.010515,0.002103
1477,952,953,1,ROT,1047,1,23,1497,1,64.586666,0.012605,0.010504,0.002101
1478,953,954,1,ROT,1046,1,34,1498,1,64.599271,0.012592,0.010493,0.002099
1479,954,955,1,ROT,1045,1,27,1499,1,64.611863,0.012579,0.010482,0.002096
1480,955,956,1,ROT,1044,1,30,1500,1,64.624442,0.012565,0.010471,0.002094
1481,956,955,1,ROT,1045,0,26,1254,1,64.637007,0.010460,0.010460,0.002094
1482,955,953,2,SCHWARZ,1047,0,34,1436,1,64.647468,0.041885,0.020942,0.002094
1483,953,949,4,ROT,1051,0,28,1258,1,64.689352,0.167891,0.041973,0.002094
1484,949,941,8,SCHWARZ,1059,0,19,1444,1,64.857243,0.674394,0.084299,0.002094
1485,941,957,16,ROT,1043,1,23,1516,1,65.531637,3.264612,0.170032,0.034006
1486,957,958,1,ROT,1042,1,19,1517,1,68.796250,0.012539,0.010449,0.002090
1487,958,959,1,ROT,1041,1,36,1518,1,68.808789,0.012526,0.010438,0.002088
1488,959,958,1,ROT,1042,0,35,1259,1,68.821315,0.010428,0.010428,0.002088
1489,958,960,2,SCHWARZ,1040,1,26,1145,1,68.831742,0.050104,0.020877,0.004175
1490,960,959,1,SCHWARZ,1041,0,23,1445,1,68.881847,0.010417,0.010417,0.004175
1491,959,957,2,ROT,1043,0,13,1261,1,68.892263,0.041710,0.020855,0.004175
1492,957,953,4,SCHWARZ,1047,0,3,1449,1,68.933974,0.167189,0.041797,0.004175
1493,953,961,8,ROT,1039,1,19,1526,1,69.101163,0.805876,0.083945,0.016789
1494,961,960,1,ROT,1040,0,6,1262,1,69.907039,0.010406,0.010406,0.016789
1495,960,962,2,SCHWARZ,1038,1,31,1147,1,69.917445,0.050000,0.020833,0.004167
1496,962,963,1,SCHWARZ,1037,1,4,1148,1,69.967445,0.012474,0.010395,0.002079
1497,963,964,1,SCHWARZ,1036,1,11,1149,1,69.979919,0.012461,0.010384,0.002077
1498,964,963,1,SCHWARZ,1037,0,12,1450,1,69.992380,0.010373,0.010373,0.002077
1499,963,965,2,ROT,1035,1,21,1528,1,70.002753,0.049844,0.020768,0.004154
1500,965,964,1,ROT,1036,0,17,1263,1,70.052597,0.010363,0.010363,0.004154
1501,964,966,2,SCHWARZ,1034,1,6,1151,1,70.062960,0.049793,0.020747,0.004149
1502,966,967,1,SCHWARZ,1033,1,6,1152,1,70.112753,0.012422,0.010352,0.002070
1503,967,968,1,SCHWARZ,1032,1,4,1153,1,70.125175,0.012410,0.010341,0.002068
1504,968,967,1,SCHWARZ,1033,0,3,1451,1,70.137585,0.010331,0.010331,0.002068
1505,967,969,2,ROT,1031,1,30,1530,1,70.147915,0.049638,0.020683,0.004137
1506,969,968,1,ROT,1032,0,15,1264,1,70.197553,0.010320,0.010320,0.004137
1507,968,966,2,SCHWARZ,1034,0,36,1453,1,70.207873,0.041322,0.020661,0.004137
1508,966,962,4,ROT,1038,0,2,1268,1,70.249195,0.165631,0.041408,0.004137
1509,962,970,8,SCHWARZ,1030,1,6,1161,1,70.414827,0.798337,0.083160,0.016632
1510,970,971,1,SCHWARZ,1029,1,8,1162,1,71.213164,0.012371,0.010309,0.002062
1511,971,972,1,SCHWARZ,1028,1,6,1163,1,71.225535,0.012358,0.010299,0.002060
1512,972,973,1,SCHWARZ,1027,1,6,1164,1,71.237893,0.012346,0.010288,0.002058
1513,973,972,1,SCHWARZ,1028,0,14,1454,1,71.250239,0.010277,0.010277,0.002058
1514,972,970,2,ROT,1030,0,15,1270,1,71.260516,0.041152,0.020576,0.002058
1515,970,966,4,SCHWARZ,1034,0,16,1458,1,71.301669,0.164948,0.041237,0.002058
1516,966,974,8,ROT,1026,1,32,1538,1,71.466617,0.795031,0.082816,0.016563
1517,974,973,1,ROT,1027,0,2,1271,1,72.261648,0.010267,0.010267,0.016563
1518,973,971,2,SCHWARZ,1029,0,27,1460,1,72.271915,0.041110,0.020555,0.016563
1519,971,967,4,ROT,1033,0,13,1275,1,72.313025,0.164779,0.041195,0.016563
1520,967,975,8,SCHWARZ,1025,1,10,1172,1,72.477804,0.794209,0.082730,0.016546
1521,975,974,1,SCHWARZ,1026,0,32,1461,1,73.272012,0.010256,0.010256,0.016546
1522,974,972,2,ROT,1028,0,11,1277,1,73.282269,0.041068,0.020534,0.016546
1523,972,968,4,SCHWARZ,1032,0,30,1465,1,73.323337,0.164609,0.041152,0.016546
1524,968,976,8,ROT,1024,1,14,1546,1,73.487946,0.793388,0.082645,0.016529
1525,976,975,1,ROT,1025,0,26,1278,1,74.281334,0.010246,0.010246,0.016529
1526,975,977,2,SCHWARZ,1023,1,2,1174,1,74.291580,0.049231,0.020513,0.004103
1527,977,978,1,SCHWARZ,1022,1,13,1175,1,74.340811,0.012282,0.010235,0.002047
1528,978,979,1,SCHWARZ,1021,1,8,1176,1,74.353093,0.012270,0.010225,0.002045
1529,979,978,1,SCHWARZ,1022,0,18,1466,1,74.365363,0.010215,0.010215,0.002045
1530,978,980,2,ROT,1020,1,21,1548,1,74.375578,0.049080,0.020450,0.004090
1531,980,979,1,ROT,1021,0,31,1279,1,74.424658,0.010204,0.010204,0.004090
1532,979,977,2,SCHWARZ,1023,0,7,1468,1,74.434862,0.040858,0.020429,0.004090
1533,977,981,4,ROT,1019,1,19,1552,1,74.475720,0.196520,0.040942,0.008188
1534,981,982,1,ROT,1018,1,23,1553,1,74.672240,0.012232,0.010194,0.002039
1535,982,981,1,ROT,1019,0,31,1280,1,74.684472,0.010183,0.010183,0.002039
1536,981,979,2,SCHWARZ,1021,0,1,1470,1,74.694655,0.040775,0.020387,0.002039
1537,979,975,4,ROT,1025,0,24,1284,1,74.735430,0.163432,0.040858,0.002039
1538,975,967,8,SCHWARZ,1033,0,23,1478,1,74.898862,0.656410,0.082051,0.002039
1539,967,983,16,ROT,1017,1,25,1569,1,75.555272,3.176836,0.165460,0.033092
1540,983,984,1,ROT,1016,1,14,1570,1,78.732108,0.012208,0.010173,0.002035
1541,984,985,1,ROT,1015,1,18,1571,1,78.744315,0.012195,0.010163,0.002033
1542,985,986,1,ROT,1014,1,21,1572,1,78.756511,0.012183,0.010152,0.002030
1543,986,985,1,ROT,1015,0,8,1285,1,78.768693,0.010142,0.010142,0.002030
1544,985,987,2,SCHWARZ,1013,1,6,1178,1,78.778835,0.048731,0.020305,0.004061
1545,987,988,1,SCHWARZ,1012,1,26,1179,1,78.827566,0.012158,0.010132,0.002026
1546,988,987,1,SCHWARZ,1013,0,27,1479,1,78.839724,0.010121,0.010121,0.002026
1547,987,985,2,ROT,1015,0,22,1287,1,78.849846,0.040527,0.020263,0.002026
1548,985,981,4,SCHWARZ,1019,0,21,1483,1,78.890373,0.162437,0.040609,0.002026
1549,981,989,8,ROT,1011,1,18,1580,1,79.052809,0.782875,0.081549,0.016310
1550,989,988,1,ROT,1012,0,35,1288,1,79.835684,0.010111,0.010111,0.016310
1551,988,990,2,SCHWARZ,1010,1,8,1181,1,79.845795,0.048583,0.020243,0.004049
1552,990,989,1,SCHWARZ,1011,0,19,1484,1,79.894378,0.010101,0.010101,0.004049
1553,989,987,2,ROT,1013,0,22,1290,1,79.904479,0.040445,0.020222,0.004049
1554,987,983,4,SCHWARZ,1017,0,0,1488,1,79.944924,0.162107,0.040527,0.004049
1555,983,991,8,ROT,1009,1,27,1588,1,80.107031,0.781282,0.081384,0.016277
1556,991,990,1,ROT,1010,0,31,1291,1,80.888313,0.010091,0.010091,0.016277
1557,990,988,2,SCHWARZ,1012,0,36,1490,1,80.898404,0.040404,0.020202,0.016277
1558,988,992,4,ROT,1008,1,32,1592,1,80.938808,0.194332,0.040486,0.008097
1559,992,991,1,ROT,1009,0,15,1292,1,81.133140,0.010081,0.010081,0.008097
1560,991,993,2,SCHWARZ,1007,1,29,1183,1,81.143221,0.048436,0.020182,0.004036
1561,993,994,1,SCHWARZ,1006,1,11,1184,1,81.191657,0.012085,0.010070,0.002014
1562,994,995,1,SCHWARZ,1005,1,13,1185,1,81.203741,0.012072,0.010060,0.002012
1563,995,996,1,SCHWARZ,1004,1,6,1186,1,81.215814,0.012060,0.010050,0.002010
1564,996,995,1,SCHWARZ,1005,0,36,1491,1,81.227874,0.010040,0.010040,0.002010
1565,995,997,2,ROT,1003,1,1,1594,1,81.237914,0.048241,0.020101,0.004020
1566,997,996,1,ROT,1004,0,6,1293,1,81.286155,0.010030,0.010030,0.004020
1567,996,994,2,SCHWARZ,1006,0,32,1493,1,81.296185,0.040161,0.020080,0.004020
1568,994,990,4,ROT,1010,0,22,1297,1,81.336346,0.160966,0.040241,0.004020
1569,990,998,8,SCHWARZ,1002,1,10,1194,1,81.497312,0.775758,0.080808,0.016162
1570,998,999,1,SCHWARZ,1001,1,15,1195,1,82.273069,0.012024,0.010020,0.002004
1571,999,998,1,SCHWARZ,1002,0,27,1494,1,82.285093,0.010010,0.010010,0.002004
1572,998,996,2,ROT,1004,0,2,1299,1,82.295103,0.040080,0.020040,0.002004
1573,996,992,4,SCHWARZ,1008,0,25,1498,1,82.335184,0.160643,0.040161,0.002004
1574,992,1000,8,ROT,1000,1,34,1602,1,82.495826,0.774194,0.080645,0.016129
1575,1000,999,1,ROT,1001,0,24,1300,1,83.270020,0.010000,0.010000,0.016129
1576,999,997,2,SCHWARZ,1003,0,3,1500,1,83.280020,0.040040,0.020020,0.016129
1577,997,993,4,ROT,1007,0,26,1304,1,83.320060,0.160481,0.040120,0.016129
1578,993,985,8,SCHWARZ,1015,0,12,1508,1,83.480541,0.644512,0.080564,0.016129
1579,985,1001,16,ROT,999,1,18,1618,1,84.125053,3.118782,0.162437,0.032487
1580,1001,1002,1,ROT,998,1,9,1619,1,87.243834,0.011988,0.009990,0.001998
1581,1002,1003,1,ROT,997,1,21,1620,1,87.255822,0.011976,0.009980,0.001996
1582,1003,1004,1,ROT,996,1,3,1621,1,87.267799,0.011964,0.009970,0.001994
1583,1004,1003,1,ROT,997,0,11,1305,1,87.279763,0.009960,0.009960,0.001994
1584,1003,1001,2,SCHWARZ,999,0,21,1510,1,87.289723,0.039880,0.019940,0.001994
1585,1001,997,4,ROT,1003,0,31,1309,1,87.329603,0.159840,0.039960,0.001994
1586,997,1005,8,SCHWARZ,995,1,29,1203,1,87.489443,0.770311,0.080241,0.016048
1587,1005,1004,1,SCHWARZ,996,0,36,1511,1,88.259754,0.009950,0.009950,0.016048
1588,1004,1006,2,ROT,994,1,7,1623,1,88.269704,0.047809,0.019920,0.003984
1589,1006,1007,1,ROT,993,1,36,1624,1,88.317513,0.011928,0.009940,0.001988
1590,1007,1008,1,ROT,992,1,23,1625,1,88.329442,0.011917,0.009930,0.001986
1591,1008,1009,1,ROT,991,1,3,1626,1,88.341358,0.011905,0.009921,0.001984
1592,1009,1008,1,ROT,992,0,8,1310,1,88.353263,0.009911,0.009911,0.001984
1593,1008,1006,2,SCHWARZ,994,0,14,1513,1,88.363174,0.039683,0.019841,0.001984
1594,1006,1002,4,ROT,998,0,11,1314,1,88.402856,0.159046,0.039761,0.001984
1595,1002,994,8,SCHWARZ,1006,0,19,1521,1,88.561902,0.638723,0.079840,0.001984
1596,994,1010,16,ROT,990,1,32,1642,1,89.200625,3.090543,0.160966,0.032193
1597,1010,1011,1,ROT,989,1,25,1643,1,92.291168,0.011881,0.009901,0.001980
1598,1011,1012,1,ROT,988,1,21,1644,1,92.303049,0.011869,0.009891,0.001978
1599,1012,1011,1,ROT,989,0,33,1315,1,92.314919,0.009881,0.009881,0.001978
1600,1011,1013,2,SCHWARZ,987,1,2,1205,1,92.324800,0.047478,0.019782,0.003956
1601,1013,1014,1,SCHWARZ,986,1,20,1206,1,92.372278,0.011846,0.009872,0.001974
1602,1014,1013,1,SCHWARZ,987,0,3,1522,1,92.384124,0.009862,0.009862,0.001974
1603,1013,1011,2,ROT,989,0,33,1317,1,92.393986,0.039487,0.019743,0.001974
1604,1011,1007,4,SCHWARZ,993,0,5,1526,1,92.433472,0.158259,0.039565,0.001974
1605,1007,999,8,ROT,1001,0,4,1325,1,92.591731,0.635551,0.079444,0.001974
1606,999,1015,16,SCHWARZ,985,1,15,1222,1,93.227283,3.075075,0.160160,0.032032
1607,1015,1016,1,SCHWARZ,984,1,22,1223,1,96.302358,0.011823,0.009852,0.001970
1608,1016,1015,1,SCHWARZ,985,0,5,1527,1,96.314180,0.009843,0.009843,0.001970
1609,1015,1013,2,ROT,987,0,22,1327,1,96.324023,0.039409,0.019704,0.001970
1610,1013,1009,4,SCHWARZ,991,0,0,1531,1,96.363432,0.157947,0.039487,0.001970
1611,1009,1017,8,ROT,983,1,23,1652,1,96.521378,0.761150,0.079286,0.015857
1612,1017,1018,1,ROT,982,1,30,1653,1,97.282528,0.011799,0.009833,0.001967
1613,1018,1019,1,ROT,981,1,30,1654,1,97.294327,0.011788,0.009823,0.001965
1614,1019,1020,1,ROT,980,1,5,1655,1,97.306115,0.011776,0.009814,0.001963
1615,1020,1019,1,ROT,981,0,4,1328,1,97.317892,0.009804,0.009804,0.001963
1616,1019,1017,2,SCHWARZ,983,0,0,1533,1,97.327695,0.039254,0.019627,0.001963
1617,1017,1021,4,ROT,979,1,21,1659,1,97.366950,0.188791,0.039331,0.007866
1618,1021,1020,1,ROT,980,0,24,1329,1,97.555740,0.009794,0.009794,0.007866
1619,1020,1018,2,SCHWARZ,982,0,18,1535,1,97.565535,0.039216,0.019608,0.007866
1620,1018,1014,4,ROT,986,0,20,1333,1,97.604750,0.157171,0.039293,0.007866
1621,1014,1022,8,SCHWARZ,978,1,2,1231,1,97.761921,0.757396,0.078895,0.015779
1622,1022,1021,1,SCHWARZ,979,0,5,1536,1,98.519318,0.009785,0.009785,0.015779
1623,1021,1023,2,ROT,977,1,23,1661,1,98.529102,0.047013,0.019589,0.003918
1624,1023,1024,1,ROT,976,1,12,1662,1,98.576115,0.011730,0.009775,0.001955
1625,1024,1023,1,ROT,977,0,22,1334,1,98.587845,0.009766,0.009766,0.001955
1626,1023,1021,2,SCHWARZ,979,0,0,1538,1,98.597611,0.039101,0.019550,0.001955
1627,1021,1017,4,ROT,983,0,0,1338,1,98.636712,0.156709,0.039177,0.001955
1628,1017,1009,8,SCHWARZ,991,0,32,1546,1,98.793421,0.629302,0.078663,0.001955
1629,1009,993,16,ROT,1007,0,17,1354,1,99.422723,2.537166,0.158573,0.001955
1630,993,1025,32,SCHWARZ,975,1,4,1263,1,101.959888,12.374622,0.322256,0.064451
1631,1025,1024,1,SCHWARZ,976,0,14,1547,1,114.334510,0.009756,0.009756,0.064451
1632,1024,1022,2,ROT,978,0,13,1356,1,114.344267,0.039062,0.019531,0.064451
1633,1022,1018,4,SCHWARZ,982,0,19,1551,1,114.383329,0.156556,0.039139,0.064451
1634,1018,1010,8,ROT,990,0,35,1364,1,114.539885,0.628684,0.078585,0.064451
1635,1010,1026,16,SCHWARZ,974,1,11,1279,1,115.168569,3.041584,0.158416,0.031683
1636,1026,1027,1,SCHWARZ,973,1,11,1280,1,118.210153,0.011696,0.009747,0.001949
1637,1027,1026,1,SCHWARZ,974,0,36,1552,1,118.221849,0.009737,0.009737,0.001949
1638,1026,1028,2,ROT,972,1,36,1664,1,118.231586,0.046784,0.019493,0.003899
1639,1028,1027,1,ROT,973,0,8,1365,1,118.278369,0.009728,0.009728,0.003899
1640,1027,1025,2,SCHWARZ,975,0,5,1554,1,118.288097,0.038948,0.019474,0.003899
1641,1025,1029,4,ROT,971,1,21,1668,1,118.327045,0.187317,0.039024,0.007805
1642,1029,1030,1,ROT,970,1,32,1669,1,118.514362,0.011662,0.009718,0.001944
1643,1030,1031,1,ROT,969,1,18,1670,1,118.526024,0.011650,0.009709,0.001942
1644,1031,1030,1,ROT,970,0,2,1366,1,118.537675,0.009699,0.009699,0.001942
1645,1030,1032,2,SCHWARZ,968,1,31,1282,1,118.547374,0.046602,0.019417,0.003883
1646,1032,1031,1,SCHWARZ,969,0,14,1555,1,118.593976,0.009690,0.009690,0.003883
1647,1031,1033,2,ROT,967,1,9,1672,1,118.603666,0.046557,0.019399,0.003880
1648,1033,1032,1,ROT,968,0,8,1367,1,118.650223,0.009681,0.009681,0.003880
1649,1032,1034,2,SCHWARZ,966,1,8,1284,1,118.659903,0.046512,0.019380,0.003876
1650,1034,1033,1,SCHWARZ,967,0,12,1556,1,118.706415,0.009671,0.009671,0.003876
1651,1033,1035,2,ROT,965,1,16,1674,1,118.716086,0.046467,0.019361,0.003872
1652,1035,1036,1,ROT,964,1,9,1675,1,118.762553,0.011594,0.009662,0.001932
1653,1036,1037,1,ROT,963,1,12,1676,1,118.774147,0.011583,0.009653,0.001931
1654,1037,1036,1,ROT,964,0,29,1368,1,118.785730,0.009643,0.009643,0.001931
1655,1036,1038,2,SCHWARZ,962,1,2,1286,1,118.795373,0.046332,0.019305,0.003861
1656,1038,1039,1,SCHWARZ,961,1,13,1287,1,118.841705,0.011561,0.009634,0.001927
1657,1039,1038,1,SCHWARZ,962,0,32,1557,1,118.853266,0.009625,0.009625,0.001927
1658,1038,1040,2,ROT,960,1,25,1678,1,118.862890,0.046243,0.019268,0.003854
1659,1040,1041,1,ROT,959,1,34,1679,1,118.909133,0.011538,0.009615,0.001923
1660,1041,1040,1,ROT,960,0,26,1369,1,118.920672,0.009606,0.009606,0.001923
1661,1040,1038,2,SCHWARZ,962,0,25,1559,1,118.930278,0.038462,0.019231,0.001923
1662,1038,1042,4,ROT,958,1,34,1683,1,118.968739,0.184971,0.038536,0.007707
1663,1042,1041,1,ROT,959,0,22,1370,1,119.153710,0.009597,0.009597,0.007707
1664,1041,1039,2,SCHWARZ,961,0,21,1561,1,119.163307,0.038425,0.019212,0.007707
1665,1039,1043,4,ROT,957,1,1,1687,1,119.201732,0.184793,0.038499,0.007700
1666,1043,1042,1,ROT,958,0,22,1371,1,119.386525,0.009588,0.009588,0.007700
1667,1042,1044,2,SCHWARZ,956,1,35,1289,1,119.396113,0.046065,0.019194,0.003839
1668,1044,1045,1,SCHWARZ,955,1,29,1290,1,119.442178,0.011494,0.009579,0.001916
1669,1045,1044,1,SCHWARZ,956,0,34,1562,1,119.453672,0.009569,0.009569,0.001916
1670,1044,1046,2,ROT,954,1,14,1689,1,119.463242,0.045977,0.019157,0.003831
1671,1046,1047,1,ROT,953,1,34,1690,1,119.509219,0.011472,0.009560,0.001912
1672,1047,1048,1,ROT,952,1,3,1691,1,119.520691,0.011461,0.009551,0.001910
1673,1048,1049,1,ROT,951,1,14,1692,1,119.532152,0.011450,0.009542,0.001908
1674,1049,1050,1,ROT,950,1,19,1693,1,119.543603,0.011439,0.009533,0.001907
1675,1050,1051,1,ROT,949,1,32,1694,1,119.555042,0.011429,0.009524,0.001905
1676,1051,1050,1,ROT,950,0,24,1372,1,119.566471,0.009515,0.009515,0.001905
1677,1050,1052,2,SCHWARZ,948,1,22,1292,1,119.575985,0.045714,0.019048,0.003810
1678,1052,1053,1,SCHWARZ,947,1,8,1293,1,119.621700,0.011407,0.009506,0.001901
1679,1053,1054,1,SCHWARZ,946,1,15,1294,1,119.633107,0.011396,0.009497,0.001899
1680,1054,1055,1,SCHWARZ,945,1,2,1295,1,119.644503,0.011385,0.009488,0.001898
1681,1055,1056,1,SCHWARZ,944,1,22,1296,1,119.655888,0.011374,0.009479,0.001896
1682,1056,1055,1,SCHWARZ,945,0,30,1563,1,119.667262,0.009470,0.009470,0.001896
1683,1055,1057,2,ROT,943,1,32,1696,1,119.676732,0.045498,0.018957,0.003791
1684,1057,1058,1,ROT,942,1,19,1697,1,119.722229,0.011353,0.009461,0.001892
1685,1058,1059,1,ROT,941,1,3,1698,1,119.733582,0.011342,0.009452,0.001890
1686,1059,1060,1,ROT,940,1,18,1699,1,119.744925,0.011331,0.009443,0.001889
1687,1060,1059,1,ROT,941,0,8,1373,1,119.756256,0.009434,0.009434,0.001889
1688,1059,1057,2,SCHWARZ,943,0,1,1565,1,119.765690,0.037771,0.018886,0.001889
1689,1057,1053,4,ROT,947,0,22,1377,1,119.803461,0.151372,0.037843,0.001889
1690,1053,1045,8,SCHWARZ,955,0,32,1573,1,119.954833,0.607787,0.075973,0.001889
1691,1045,1029,16,ROT,971,0,31,1393,1,120.562620,2.449761,0.153110,0.001889
1692,1029,1061,32,SCHWARZ,939,1,35,1328,1,123.012381,11.941691,0.310982,0.062196
1693,1061,1060,1,SCHWARZ,940,0,18,1574,1,134.954072,0.009425,0.009425,0.062196
1694,1060,1062,2,ROT,938,1,25,1701,1,134.963497,0.045283,0.018868,0.003774
1695,1062,1061,1,ROT,939,0,26,1394,1,135.008780,0.009416,0.009416,0.003774
1696,1061,1059,2,SCHWARZ,941,0,16,1576,1,135.018197,0.037700,0.018850,0.003774
1697,1059,1055,4,ROT,945,0,28,1398,1,135.055897,0.151086,0.037771,0.003774
1698,1055,1047,8,SCHWARZ,953,0,9,1584,1,135.206983,0.606635,0.075829,0.003774
1699,1047,1031,16,ROT,969,0,29,1414,1,135.813618,2.445081,0.152818,0.003774
1700,1031,999,32,SCHWARZ,1001,0,16,1616,1,138.258699,9.932105,0.310378,0.003774
1701,999,935,64,ROT,1065,0,15,1478,1,148.190804,41.001001,0.640641,0.003774
1702,935,936,1,SCHWARZ,1064,1,20,1329,1,189.191805,0.012834,0.010695,0.002139
1703,936,937,1,SCHWARZ,1063,1,8,1330,1,189.204639,0.012821,0.010684,0.002137
1704,937,936,1,SCHWARZ,1064,0,34,1617,1,189.217459,0.010672,0.010672,0.002137
1705,936,934,2,ROT,1066,0,24,1480,1,189.228132,0.042735,0.021368,0.002137
1706,934,938,4,SCHWARZ,1062,1,22,1334,1,189.270867,0.205567,0.042827,0.008565
1707,938,939,1,SCHWARZ,1061,1,13,1335,1,189.476434,0.012793,0.010661,0.002132
1708,939,940,1,SCHWARZ,1060,1,17,1336,1,189.489228,0.012780,0.010650,0.002130
1709,940,939,1,SCHWARZ,1061,0,12,1618,1,189.502007,0.010638,0.010638,0.002130
1710,939,937,2,ROT,1063,0,0,1482,1,189.512645,0.042599,0.021299,0.002130
1711,937,941,4,SCHWARZ,1059,1,6,1340,1,189.555244,0.204909,0.042689,0.008538
1712,941,942,1,SCHWARZ,1058,1,33,1341,1,189.760153,0.012752,0.010627,0.002125
1713,942,941,1,SCHWARZ,1059,0,1,1619,1,189.772906,0.010616,0.010616,0.002125
1714,941,943,2,ROT,1057,1,16,1703,1,189.783521,0.051010,0.021254,0.004251
1715,943,944,1,ROT,1056,1,32,1704,1,189.834531,0.012725,0.010604,0.002121
1716,944,943,1,ROT,1057,0,29,1483,1,189.847256,0.010593,0.010593,0.002121
1717,943,945,2,SCHWARZ,1055,1,24,1343,1,189.857849,0.050901,0.021209,0.004242
1718,945,946,1,SCHWARZ,1054,1,29,1344,1,189.908751,0.012698,0.010582,0.002116
1719,946,947,1,SCHWARZ,1053,1,22,1345,1,189.921449,0.012685,0.010571,0.002114
1720,947,946,1,SCHWARZ,1054,0,19,1620,1,189.934134,0.010560,0.010560,0.002114
1721,946,944,2,ROT,1056,0,29,1485,1,189.944694,0.042283,0.021142,0.002114
1722,944,940,4,SCHWARZ,1060,0,21,1624,1,189.986977,0.169492,0.042373,0.002114
1723,940,932,8,ROT,1068,0,2,1493,1,190.156469,0.680851,0.085106,0.002114
1724,932,916,16,SCHWARZ,1084,0,1,1640,1,190.837320,2.746781,0.171674,0.002114
1725,916,948,32,ROT,1052,1,30,1736,1,193.584101,13.414847,0.349345,0.069869
1726,948,949,1,ROT,1051,1,34,1737,1,206.998948,0.012658,0.010549,0.002110
1727,949,950,1,ROT,1050,1,1,1738,1,207.011606,0.012645,0.010537,0.002107
1728,950,951,1,ROT,1049,1,19,1739,1,207.024251,0.012632,0.010526,0.002105
1729,951,950,1,ROT,1050,0,24,1494,1,207.036883,0.010515,0.010515,0.002105
1730,950,948,2,SCHWARZ,1052,0,12,1642,1,207.047398,0.042105,0.021053,0.002105
1731,948,952,4,ROT,1048,1,30,1743,1,207.089503,0.202532,0.042194,0.008439
1732,952,953,1,ROT,1047,1,16,1744,1,207.292035,0.012605,0.010504,0.002101
1733,953,954,1,ROT,1046,1,12,1745,1,207.304640,0.012592,0.010493,0.002099
1734,954,953,1,ROT,1047,0,26,1495,1,207.317232,0.010482,0.010482,0.002099
1735,953,951,2,SCHWARZ,1049,0,21,1644,1,207.327714,0.041973,0.020986,0.002099
1736,951,955,4,ROT,1045,1,7,1749,1,207.369687,0.201893,0.042061,0.008412
1737,955,956,1,ROT,1044,1,5,1750,1,207.571579,0.012565,0.010471,0.002094
1738,956,955,1,ROT,1045,0,35,1496,1,207.584145,0.010460,0.010460,0.002094
1739,955,957,2,SCHWARZ,1043,1,6,1347,1,207.594605,0.050262,0.020942,0.004188
1740,957,956,1,SCHWARZ,1044,0,1,1645,1,207.644867,0.010449,0.010449,0.004188
1741,956,958,2,ROT,1042,1,7,1752,1,207.655316,0.050209,0.020921,0.004184
1742,958,959,1,ROT,1041,1,9,1753,1,207.705525,0.012526,0.010438,0.002088
1743,959,958,1,ROT,1042,0,2,1497,1,207.718051,0.010428,0.010428,0.002088
1744,958,960,2,SCHWARZ,1040,1,2,1349,1,207.728479,0.050104,0.020877,0.004175
1745,960,961,1,SCHWARZ,1039,1,29,1350,1,207.778583,0.012500,0.010417,0.002083
1746,961,960,1,SCHWARZ,1040,0,12,1646,1,207.791083,0.010406,0.010406,0.002083
1747,960,962,2,ROT,1038,1,5,1755,1,207.801489,0.050000,0.020833,0.004167
1748,962,963,1,ROT,1037,1,32,1756,1,207.851489,0.012474,0.010395,0.002079
1749,963,964,1,ROT,1036,1,19,1757,1,207.863963,0.012461,0.010384,0.002077
1750,964,963,1,ROT,1037,0,28,1498,1,207.876424,0.010373,0.010373,0.002077
1751,963,965,2,SCHWARZ,1035,1,20,1352,1,207.886798,0.049844,0.020768,0.004154
1752,965,966,1,SCHWARZ,1034,1,26,1353,1,207.936642,0.012435,0.010363,0.002073
1753,966,965,1,SCHWARZ,1035,0,5,1647,1,207.949077,0.010352,0.010352,0.002073
1754,965,967,2,ROT,1033,1,16,1759,1,207.959429,0.049741,0.020725,0.004145
1755,967,966,1,ROT,1034,0,4,1499,1,208.009170,0.010341,0.010341,0.004145
1756,966,964,2,SCHWARZ,1036,0,23,1649,1,208.019511,0.041408,0.020704,0.004145
1757,964,968,4,ROT,1032,1,16,1763,1,208.060919,0.199170,0.041494,0.008299
1758,968,969,1,ROT,1031,1,19,1764,1,208.260089,0.012397,0.010331,0.002066
1759,969,970,1,ROT,1030,1,32,1765,1,208.272486,0.012384,0.010320,0.002064
1760,970,969,1,ROT,1031,0,26,1500,1,208.284870,0.010309,0.010309,0.002064
1761,969,967,2,SCHWARZ,1033,0,14,1651,1,208.295179,0.041280,0.020640,0.002064
1762,967,963,4,ROT,1037,0,8,1504,1,208.336459,0.165460,0.041365,0.002064
1763,963,971,8,SCHWARZ,1029,1,8,1361,1,208.501919,0.797508,0.083074,0.016615
1764,971,970,1,SCHWARZ,1030,0,27,1652,1,209.299427,0.010299,0.010299,0.016615
1765,970,972,2,ROT,1028,1,21,1767,1,209.309726,0.049485,0.020619,0.004124
1766,972,971,1,ROT,1029,0,28,1505,1,209.359210,0.010288,0.010288,0.004124
1767,971,973,2,SCHWARZ,1027,1,31,1363,1,209.369498,0.049434,0.020597,0.004119
1768,973,974,1,SCHWARZ,1026,1,15,1364,1,209.418932,0.012333,0.010277,0.002055
1769,974,975,1,SCHWARZ,1025,1,22,1365,1,209.431265,0.012320,0.010267,0.002053
1770,975,974,1,SCHWARZ,1026,0,9,1653,1,209.443585,0.010256,0.010256,0.002053
1771,974,972,2,ROT,1028,0,8,1507,1,209.453841,0.041068,0.020534,0.002053
1772,972,976,4,SCHWARZ,1024,1,10,1369,1,209.494909,0.197531,0.041152,0.008230
1773,976,977,1,SCHWARZ,1023,1,33,1370,1,209.692440,0.012295,0.010246,0.002049
1774,977,976,1,SCHWARZ,1024,0,1,1654,1,209.704735,0.010235,0.010235,0.002049
1775,976,974,2,ROT,1026,0,8,1509,1,209.714971,0.040984,0.020492,0.002049
1776,974,970,4,SCHWARZ,1030,0,5,1658,1,209.755954,0.164271,0.041068,0.002049
1777,970,978,8,ROT,1022,1,23,1775,1,209.920225,0.791753,0.082474,0.016495
1778,978,977,1,ROT,1023,0,22,1510,1,210.711978,0.010225,0.010225,0.016495
1779,977,979,2,SCHWARZ,1021,1,6,1372,1,210.722203,0.049130,0.020471,0.004094
1780,979,978,1,SCHWARZ,1022,0,36,1659,1,210.771333,0.010215,0.010215,0.004094
1781,978,976,2,ROT,1024,0,4,1512,1,210.781547,0.040900,0.020450,0.004094
1782,976,972,4,SCHWARZ,1028,0,27,1663,1,210.822447,0.163934,0.040984,0.004094
1783,972,980,8,ROT,1020,1,18,1783,1,210.986381,0.790123,0.082305,0.016461
1784,980,979,1,ROT,1021,0,17,1513,1,211.776505,0.010204,0.010204,0.016461
1785,979,981,2,SCHWARZ,1019,1,28,1374,1,211.786709,0.049030,0.020429,0.004086
1786,981,982,1,SCHWARZ,1018,1,15,1375,1,211.835739,0.012232,0.010194,0.002039
1787,982,983,1,SCHWARZ,1017,1,28,1376,1,211.847971,0.012220,0.010183,0.002037
1788,983,984,1,SCHWARZ,1016,1,4,1377,1,211.860191,0.012208,0.010173,0.002035
1789,984,983,1,SCHWARZ,1017,0,23,1664,1,211.872399,0.010163,0.010163,0.002035
1790,983,985,2,ROT,1015,1,23,1785,1,211.882561,0.048830,0.020346,0.004069
1791,985,986,1,ROT,1014,1,9,1786,1,211.931391,0.012183,0.010152,0.002030
1792,986,985,1,ROT,1015,0,6,1514,1,211.943574,0.010142,0.010142,0.002030
1793,985,987,2,SCHWARZ,1013,1,13,1379,1,211.953716,0.048731,0.020305,0.004061
1794,987,988,1,SCHWARZ,1012,1,11,1380,1,212.002447,0.012158,0.010132,0.002026
1795,988,987,1,SCHWARZ,1013,0,12,1665,1,212.014605,0.010121,0.010121,0.002026
1796,987,985,2,ROT,1015,0,31,1516,1,212.024726,0.040527,0.020263,0.002026
1797,985,981,4,SCHWARZ,1019,0,7,1669,1,212.065253,0.162437,0.040609,0.002026
1798,981,989,8,ROT,1011,1,21,1794,1,212.227690,0.782875,0.081549,0.016310
1799,989,990,1,ROT,1010,1,34,1795,1,213.010564,0.012133,0.010111,0.002022
1800,990,991,1,ROT,1009,1,14,1796,1,213.022698,0.012121,0.010101,0.002020
1801,991,990,1,ROT,1010,0,35,1517,1,213.034819,0.010091,0.010091,0.002020
1802,990,992,2,SCHWARZ,1008,1,31,1382,1,213.044910,0.048485,0.020202,0.004040
1803,992,991,1,SCHWARZ,1009,0,23,1670,1,213.093395,0.010081,0.010081,0.004040
1804,991,993,2,ROT,1007,1,25,1798,1,213.103475,0.048436,0.020182,0.004036
1805,993,994,1,ROT,1006,1,19,1799,1,213.151911,0.012085,0.010070,0.002014
1806,994,995,1,ROT,1005,1,19,1800,1,213.163996,0.012072,0.010060,0.002012
1807,995,996,1,ROT,1004,1,7,1801,1,213.176068,0.012060,0.010050,0.002010
1808,996,997,1,ROT,1003,1,27,1802,1,213.188129,0.012048,0.010040,0.002008
1809,997,996,1,ROT,1004,0,20,1518,1,213.200177,0.010030,0.010030,0.002008
1810,996,994,2,SCHWARZ,1006,0,3,1672,1,213.210207,0.040161,0.020080,0.002008
1811,994,998,4,ROT,1002,1,5,1806,1,213.250368,0.193159,0.040241,0.008048
1812,998,997,1,ROT,1003,0,28,1519,1,213.443527,0.010020,0.010020,0.008048
1813,997,999,2,SCHWARZ,1001,1,22,1384,1,213.453547,0.048144,0.020060,0.004012
1814,999,1000,1,SCHWARZ,1000,1,22,1385,1,213.501691,0.012012,0.010010,0.002002
1815,1000,999,1,SCHWARZ,1001,0,7,1673,1,213.513703,0.010000,0.010000,0.002002
1816,999,997,2,ROT,1003,0,22,1521,1,213.523703,0.040040,0.020020,0.002002
1817,997,993,4,SCHWARZ,1007,0,36,1677,1,213.563743,0.160481,0.040120,0.002002
1818,993,1001,8,ROT,999,1,18,1814,1,213.724225,0.773414,0.080564,0.016113
1819,1001,1002,1,ROT,998,1,25,1815,1,214.497638,0.011988,0.009990,0.001998
1820,1002,1003,1,ROT,997,1,12,1816,1,214.509626,0.011976,0.009980,0.001996
1821,1003,1002,1,ROT,998,0,13,1522,1,214.521603,0.009970,0.009970,0.001996
1822,1002,1000,2,SCHWARZ,1000,0,36,1679,1,214.531573,0.039920,0.019960,0.001996
1823,1000,996,4,ROT,1004,0,17,1526,1,214.571493,0.160000,0.040000,0.001996
1824,996,988,8,SCHWARZ,1012,0,9,1687,1,214.731493,0.642570,0.080321,0.001996
1825,988,972,16,ROT,1028,0,29,1542,1,215.374063,2.591093,0.161943,0.001996
1826,972,940,32,SCHWARZ,1060,0,12,1719,1,217.965156,10.534979,0.329218,0.001996
1827,940,876,64,ROT,1124,0,10,1606,1,228.500136,43.574468,0.680851,0.001996
1828,876,875,1,SCHWARZ,1125,0,16,1720,1,272.074604,0.011416,0.011416,0.001996
1829,875,873,2,ROT,1127,0,0,1608,1,272.086019,0.045714,0.022857,0.001996
1830,873,869,4,SCHWARZ,1131,0,34,1724,1,272.131733,0.183276,0.045819,0.001996
1831,869,877,8,ROT,1123,1,23,1824,1,272.315010,0.883774,0.092060,0.018412
1832,877,878,1,ROT,1122,1,34,1825,1,273.198784,0.013683,0.011403,0.002281
1833,878,879,1,ROT,1121,1,25,1826,1,273.212467,0.013667,0.011390,0.002278
1834,879,878,1,ROT,1122,0,10,1609,1,273.226134,0.011377,0.011377,0.002278
1835,878,880,2,SCHWARZ,1120,1,8,1387,1,273.237511,0.054670,0.022779,0.004556
1836,880,881,1,SCHWARZ,1119,1,4,1388,1,273.292181,0.013636,0.011364,0.002273
1837,881,880,1,SCHWARZ,1120,0,36,1725,1,273.305817,0.011351,0.011351,0.002273
1838,880,882,2,ROT,1118,1,7,1828,1,273.317168,0.054545,0.022727,0.004545
1839,882,883,1,ROT,1117,1,27,1829,1,273.371713,0.013605,0.011338,0.002268
1840,883,882,1,ROT,1118,0,6,1610,1,273.385319,0.011325,0.011325,0.002268
1841,882,884,2,SCHWARZ,1116,1,33,1390,1,273.396644,0.054422,0.022676,0.004535
1842,884,883,1,SCHWARZ,1117,0,0,1726,1,273.451065,0.011312,0.011312,0.004535
1843,883,885,2,ROT,1115,1,14,1831,1,273.462378,0.054360,0.022650,0.004530
1844,885,886,1,ROT,1114,1,25,1832,1,273.516738,0.013559,0.011299,0.002260
1845,886,887,1,ROT,1113,1,3,1833,1,273.530297,0.013544,0.011287,0.002257
1846,887,888,1,ROT,1112,1,9,1834,1,273.543841,0.013529,0.011274,0.002255
1847,888,887,1,ROT,1113,0,22,1611,1,273.557370,0.011261,0.011261,0.002255
1848,887,885,2,SCHWARZ,1115,0,23,1728,1,273.568631,0.045096,0.022548,0.002255
1849,885,889,4,ROT,1111,1,5,1838,1,273.613727,0.216949,0.045198,0.009040
1850,889,890,1,ROT,1110,1,30,1839,1,273.830676,0.013498,0.011249,0.002250
1851,890,889,1,ROT,1111,0,20,1612,1,273.844174,0.011236,0.011236,0.002250
1852,889,891,2,SCHWARZ,1109,1,35,1392,1,273.855410,0.053993,0.022497,0.004499
1853,891,890,1,SCHWARZ,1110,0,34,1729,1,273.909404,0.011223,0.011223,0.004499
1854,890,888,2,ROT,1112,0,26,1614,1,273.920627,0.044944,0.022472,0.004499
1855,888,892,4,SCHWARZ,1108,1,2,1396,1,273.965571,0.216216,0.045045,0.009009
1856,892,891,1,SCHWARZ,1109,0,34,1730,1,274.181787,0.011211,0.011211,0.009009
1857,891,889,2,ROT,1111,0,28,1616,1,274.192998,0.044893,0.022447,0.009009
1858,889,885,4,SCHWARZ,1115,0,14,1734,1,274.237891,0.179978,0.044994,0.009009
1859,885,893,8,ROT,1107,1,21,1847,1,274.417869,0.867797,0.090395,0.018079
1860,893,892,1,ROT,1108,0,15,1617,1,275.285665,0.011198,0.011198,0.018079
1861,892,894,2,SCHWARZ,1106,1,29,1398,1,275.296864,0.053812,0.022422,0.004484
1862,894,893,1,SCHWARZ,1107,0,12,1735,1,275.350675,0.011186,0.011186,0.004484
1863,893,891,2,ROT,1109,0,13,1619,1,275.361861,0.044793,0.022396,0.004484
1864,891,895,4,SCHWARZ,1105,1,35,1402,1,275.406654,0.215488,0.044893,0.008979
1865,895,896,1,SCHWARZ,1104,1,11,1403,1,275.622142,0.013408,0.011173,0.002235
1866,896,895,1,SCHWARZ,1105,0,14,1736,1,275.635550,0.011161,0.011161,0.002235
1867,895,893,2,ROT,1107,0,29,1621,1,275.646710,0.044693,0.022346,0.002235
1868,893,897,4,SCHWARZ,1103,1,13,1407,1,275.691403,0.215006,0.044793,0.008959
1869,897,896,1,SCHWARZ,1104,0,25,1737,1,275.906409,0.011148,0.011148,0.008959
1870,896,894,2,ROT,1106,0,13,1623,1,275.917557,0.044643,0.022321,0.008959
1871,894,898,4,SCHWARZ,1102,1,33,1411,1,275.962200,0.214765,0.044743,0.008949
1872,898,899,1,SCHWARZ,1101,1,26,1412,1,276.176965,0.013363,0.011136,0.002227
1873,899,900,1,SCHWARZ,1100,1,35,1413,1,276.190328,0.013348,0.011123,0.002225
1874,900,901,1,SCHWARZ,1099,1,8,1414,1,276.203676,0.013333,0.011111,0.002222
1875,901,900,1,SCHWARZ,1100,0,21,1738,1,276.217010,0.011099,0.011099,0.002222
1876,900,898,2,ROT,1102,0,2,1625,1,276.228108,0.044444,0.022222,0.002222
1877,898,894,4,SCHWARZ,1106,0,25,1742,1,276.272553,0.178174,0.044543,0.002222
1878,894,886,8,ROT,1114,0,0,1633,1,276.450727,0.715884,0.089485,0.002222
1879,886,870,16,SCHWARZ,1130,0,0,1758,1,277.166610,2.889391,0.180587,0.002222
1880,870,838,32,ROT,1162,0,6,1665,1,280.056001,11.770115,0.367816,0.002222
1881,838,902,64,SCHWARZ,1098,1,33,1478,1,291.826116,58.653938,0.763723,0.152745
1882,902,903,1,SCHWARZ,1097,1,26,1479,1,350.480054,0.013304,0.011086,0.002217
1883,903,904,1,SCHWARZ,1096,1,11,1480,1,350.493358,0.013289,0.011074,0.002215
1884,904,903,1,SCHWARZ,1097,0,14,1759,1,350.506647,0.011062,0.011062,0.002215
1885,903,901,2,ROT,1099,0,20,1667,1,350.517708,0.044297,0.022148,0.002215
1886,901,897,4,SCHWARZ,1103,0,18,1763,1,350.562005,0.177580,0.044395,0.002215
1887,897,905,8,ROT,1095,1,21,1855,1,350.739586,0.856187,0.089186,0.017837
1888,905,906,1,ROT,1094,1,25,1856,1,351.595773,0.013260,0.011050,0.002210
1889,906,905,1,ROT,1095,0,31,1668,1,351.609033,0.011038,0.011038,0.002210
1890,905,907,2,SCHWARZ,1093,1,26,1482,1,351.620070,0.053039,0.022099,0.004420
1891,907,906,1,SCHWARZ,1094,0,23,1764,1,351.673109,0.011025,0.011025,0.004420
1892,906,904,2,ROT,1096,0,4,1670,1,351.684134,0.044150,0.022075,0.004420
1893,904,900,4,SCHWARZ,1100,0,0,1768,1,351.728284,0.176991,0.044248,0.004420
1894,900,908,8,ROT,1092,1,19,1864,1,351.905276,0.853333,0.088889,0.017778
1895,908,909,1,ROT,1091,1,7,1865,1,352.758609,0.013216,0.011013,0.002203
1896,909,910,1,ROT,1090,1,34,1866,1,352.771825,0.013201,0.011001,0.002200
1897,910,911,1,ROT,1089,1,34,1867,1,352.785026,0.013187,0.010989,0.002198
1898,911,912,1,ROT,1088,1,18,1868,1,352.798213,0.013172,0.010977,0.002195
1899,912,911,1,ROT,1089,0,35,1671,1,352.811385,0.010965,0.010965,0.002195
1900,911,909,2,SCHWARZ,1091,0,9,1770,1,352.822350,0.043908,0.021954,0.002195
1901,909,905,4,ROT,1095,0,20,1675,1,352.866258,0.176018,0.044004,0.002195
1902,905,913,8,SCHWARZ,1087,1,35,1490,1,353.042275,0.848619,0.088398,0.017680
1903,913,914,1,SCHWARZ,1086,1,26,1491,1,353.890894,0.013143,0.010953,0.002191
1904,914,913,1,SCHWARZ,1087,0,19,1771,1,353.904038,0.010941,0.010941,0.002191
1905,913,911,2,ROT,1089,0,20,1677,1,353.914979,0.043812,0.021906,0.002191
1906,911,915,4,SCHWARZ,1085,1,33,1495,1,353.958790,0.210757,0.043908,0.008782
1907,915,916,1,SCHWARZ,1084,1,22,1496,1,354.169548,0.013115,0.010929,0.002186
1908,916,915,1,SCHWARZ,1085,0,16,1772,1,354.182662,0.010917,0.010917,0.002186
1909,915,917,2,ROT,1083,1,34,1870,1,354.193579,0.052459,0.021858,0.004372
1910,917,916,1,ROT,1084,0,24,1678,1,354.246039,0.010905,0.010905,0.004372
1911,916,914,2,SCHWARZ,1086,0,16,1774,1,354.256944,0.043668,0.021834,0.004372
1912,914,918,4,ROT,1082,1,5,1874,1,354.300612,0.210066,0.043764,0.008753
1913,918,917,1,ROT,1083,0,0,1679,1,354.510677,0.010893,0.010893,0.008753
1914,917,919,2,SCHWARZ,1081,1,4,1498,1,354.521571,0.052345,0.021810,0.004362
1915,919,918,1,SCHWARZ,1082,0,1,1775,1,354.573915,0.010881,0.010881,0.004362
1916,918,916,2,ROT,1084,0,20,1681,1,354.584797,0.043573,0.021786,0.004362
1917,916,912,4,SCHWARZ,1088,0,14,1779,1,354.628370,0.174672,0.043668,0.004362
1918,912,920,8,ROT,1080,1,1,1882,1,354.803042,0.842105,0.087719,0.017544
1919,920,919,1,ROT,1081,0,31,1682,1,355.645147,0.010870,0.010870,0.017544
1920,919,917,2,SCHWARZ,1083,0,18,1781,1,355.656017,0.043526,0.021763,0.017544
1921,917,921,4,ROT,1079,1,3,1886,1,355.699543,0.209378,0.043621,0.008724
1922,921,922,1,ROT,1078,1,3,1887,1,355.908921,0.013029,0.010858,0.002172
1923,922,921,1,ROT,1079,0,8,1683,1,355.921950,0.010846,0.010846,0.002172
1924,921,919,2,SCHWARZ,1081,0,30,1783,1,355.932796,0.043431,0.021716,0.002172
1925,919,915,4,ROT,1085,0,26,1687,1,355.976227,0.174102,0.043526,0.002172
1926,915,923,8,SCHWARZ,1077,1,31,1506,1,356.150330,0.839344,0.087432,0.017486
1927,923,924,1,SCHWARZ,1076,1,4,1507,1,356.989674,0.013001,0.010834,0.002167
1928,924,923,1,SCHWARZ,1077,0,16,1784,1,357.002675,0.010823,0.010823,0.002167
1929,923,925,2,ROT,1075,1,27,1889,1,357.013497,0.052004,0.021668,0.004334
1930,925,924,1,ROT,1076,0,29,1688,1,357.065502,0.010811,0.010811,0.004334
1931,924,922,2,SCHWARZ,1078,0,1,1786,1,357.076313,0.043290,0.021645,0.004334
1932,922,926,4,ROT,1074,1,32,1893,1,357.119603,0.208243,0.043384,0.008677
1933,926,925,1,ROT,1075,0,17,1689,1,357.327846,0.010799,0.010799,0.008677
1934,925,927,2,SCHWARZ,1073,1,2,1509,1,357.338645,0.051892,0.021622,0.004324
1935,927,928,1,SCHWARZ,1072,1,15,1510,1,357.390537,0.012945,0.010787,0.002157
1936,928,927,1,SCHWARZ,1073,0,1,1787,1,357.403482,0.010776,0.010776,0.002157
1937,927,929,2,ROT,1071,1,3,1895,1,357.414257,0.051780,0.021575,0.004315
1938,929,930,1,ROT,1070,1,18,1896,1,357.466037,0.012917,0.010764,0.002153
1939,930,931,1,ROT,1069,1,34,1897,1,357.478954,0.012903,0.010753,0.002151
1940,931,930,1,ROT,1070,0,35,1690,1,357.491858,0.010741,0.010741,0.002151
1941,930,928,2,SCHWARZ,1072,0,30,1789,1,357.502599,0.043011,0.021505,0.002151
1942,928,932,4,ROT,1068,1,5,1901,1,357.545610,0.206897,0.043103,0.008621
1943,932,931,1,ROT,1069,0,10,1691,1,357.752506,0.010730,0.010730,0.008621
1944,931,933,2,SCHWARZ,1067,1,8,1512,1,357.763236,0.051557,0.021482,0.004296
1945,933,932,1,SCHWARZ,1068,0,34,1790,1,357.814793,0.010718,0.010718,0.004296
1946,932,934,2,ROT,1066,1,21,1903,1,357.825511,0.051502,0.021459,0.004292
1947,934,933,1,ROT,1067,0,26,1692,1,357.877013,0.010707,0.010707,0.004292
1948,933,935,2,SCHWARZ,1065,1,13,1514,1,357.887720,0.051447,0.021436,0.004287
1949,935,934,1,SCHWARZ,1066,0,21,1791,1,357.939167,0.010695,0.010695,0.004287
1950,934,936,2,ROT,1064,1,3,1905,1,357.949862,0.051392,0.021413,0.004283
1951,936,935,1,ROT,1065,0,33,1693,1,358.001254,0.010684,0.010684,0.004283
1952,935,937,2,SCHWARZ,1063,1,24,1516,1,358.011938,0.051337,0.021390,0.004278
1953,937,938,1,SCHWARZ,1062,1,35,1517,1,358.063275,0.012807,0.010672,0.002134
1954,938,939,1,SCHWARZ,1061,1,13,1518,1,358.076082,0.012793,0.010661,0.002132
1955,939,938,1,SCHWARZ,1062,0,16,1792,1,358.088875,0.010650,0.010650,0.002132
1956,938,940,2,ROT,1060,1,16,1907,1,358.099524,0.051173,0.021322,0.004264
1957,940,939,1,ROT,1061,0,22,1694,1,358.150697,0.010638,0.010638,0.004264
1958,939,941,2,SCHWARZ,1059,1,17,1520,1,358.161335,0.051118,0.021299,0.004260
1959,941,940,1,SCHWARZ,1060,0,36,1793,1,358.212454,0.010627,0.010627,0.004260
1960,940,938,2,ROT,1062,0,33,1696,1,358.223081,0.042553,0.021277,0.004260
1961,938,942,4,SCHWARZ,1058,1,35,1524,1,358.265634,0.204691,0.042644,0.008529
1962,942,943,1,SCHWARZ,1057,1,29,1525,1,358.470325,0.012739,0.010616,0.002123
1963,943,942,1,SCHWARZ,1058,0,3,1794,1,358.483064,0.010604,0.010604,0.002123
1964,942,940,2,ROT,1060,0,35,1698,1,358.493668,0.042463,0.021231,0.002123
1965,940,944,4,SCHWARZ,1056,1,28,1529,1,358.536131,0.204255,0.042553,0.008511
1966,944,943,1,SCHWARZ,1057,0,30,1795,1,358.740386,0.010593,0.010593,0.008511
1967,943,945,2,ROT,1055,1,19,1909,1,358.750979,0.050901,0.021209,0.004242
1968,945,946,1,ROT,1054,1,30,1910,1,358.801881,0.012698,0.010582,0.002116
1969,946,945,1,ROT,1055,0,8,1699,1,358.814579,0.010571,0.010571,0.002116
1970,945,947,2,SCHWARZ,1053,1,8,1531,1,358.825150,0.050794,0.021164,0.004233
1971,947,948,1,SCHWARZ,1052,1,28,1532,1,358.875944,0.012672,0.010560,0.002112
1972,948,949,1,SCHWARZ,1051,1,4,1533,1,358.888615,0.012658,0.010549,0.002110
1973,949,950,1,SCHWARZ,1050,1,17,1534,1,358.901273,0.012645,0.010537,0.002107
1974,950,949,1,SCHWARZ,1051,0,36,1796,1,358.913918,0.010526,0.010526,0.002107
1975,949,947,2,ROT,1053,0,0,1701,1,358.924445,0.042150,0.021075,0.002107
1976,947,951,4,SCHWARZ,1049,1,11,1538,1,358.966594,0.202746,0.042239,0.008448
1977,951,950,1,SCHWARZ,1050,0,30,1797,1,359.169340,0.010515,0.010515,0.008448
1978,950,948,2,ROT,1052,0,26,1703,1,359.179855,0.042105,0.021053,0.008448
1979,948,944,4,SCHWARZ,1056,0,32,1801,1,359.221960,0.168776,0.042194,0.008448
1980,944,936,8,ROT,1064,0,31,1711,1,359.390737,0.677966,0.084746,0.008448
1981,936,920,16,SCHWARZ,1080,0,7,1817,1,360.068703,2.735043,0.170940,0.008448
1982,920,888,32,ROT,1112,0,10,1743,1,362.803746,11.130435,0.347826,0.008448
1983,888,952,64,SCHWARZ,1048,1,24,1602,1,373.934180,55.351351,0.720721,0.144144
1984,952,953,1,SCHWARZ,1047,1,26,1603,1,429.285532,0.012605,0.010504,0.002101
1985,953,954,1,SCHWARZ,1046,1,24,1604,1,429.298137,0.012592,0.010493,0.002099
1986,954,955,1,SCHWARZ,1045,1,29,1605,1,429.310729,0.012579,0.010482,0.002096
1987,955,954,1,SCHWARZ,1046,0,21,1818,1,429.323307,0.010471,0.010471,0.002096
1988,954,956,2,ROT,1044,1,12,1912,1,429.333778,0.050314,0.020964,0.004193
1989,956,955,1,ROT,1045,0,22,1744,1,429.384093,0.010460,0.010460,0.004193
1990,955,957,2,SCHWARZ,1043,1,13,1607,1,429.394553,0.050262,0.020942,0.004188
1991,957,956,1,SCHWARZ,1044,0,36,1819,1,429.444815,0.010449,0.010449,0.004188
1992,956,958,2,ROT,1042,1,9,1914,1,429.455264,0.050209,0.020921,0.004184
1993,958,957,1,ROT,1043,0,20,1745,1,429.505473,0.010438,0.010438,0.004184
1994,957,955,2,SCHWARZ,1045,0,19,1821,1,429.515912,0.041797,0.020899,0.004184
1995,955,959,4,ROT,1041,1,3,1918,1,429.557709,0.201047,0.041885,0.008377
1996,959,958,1,ROT,1042,0,35,1746,1,429.758756,0.010428,0.010428,0.008377
1997,958,956,2,SCHWARZ,1044,0,0,1823,1,429.769184,0.041754,0.020877,0.008377
1998,956,952,4,ROT,1048,0,8,1750,1,429.810937,0.167364,0.041841,0.008377
1999,952,944,8,SCHWARZ,1056,0,23,1831,1,429.978301,0.672269,0.084034,0.008377
2000,944,960,16,ROT,1040,1,30,1934,1,430.650570,3.254237,0.169492,0.033898
2001,960,959,1,ROT,1041,0,28,1751,1,433.904808,0.010417,0.010417,0.033898
2002,959,957,2,SCHWARZ,1043,0,3,1833,1,433.915224,0.041710,0.020855,0.033898
2003,957,953,4,ROT,1047,0,8,1755,1,433.956934,0.167189,0.041797,0.033898
2004,953,961,8,SCHWARZ,1039,1,2,1615,1,434.124124,0.805876,0.083945,0.016789
2005,961,962,1,SCHWARZ,1038,1,28,1616,1,434.930000,0.012487,0.010406,0.002081
2006,962,961,1,SCHWARZ,1039,0,23,1834,1,434.942487,0.010395,0.010395,0.002081
2007,961,959,2,ROT,1041,0,2,1757,1,434.952882,0.041623,0.020812,0.002081
2008,959,963,4,SCHWARZ,1037,1,29,1620,1,434.994505,0.200209,0.041710,0.008342
2009,963,964,1,SCHWARZ,1036,1,17,1621,1,435.194714,0.012461,0.010384,0.002077
2010,964,965,1,SCHWARZ,1035,1,26,1622,1,435.207175,0.012448,0.010373,0.002075
2011,965,966,1,SCHWARZ,1034,1,13,1623,1,435.219623,0.012435,0.010363,0.002073
2012,966,965,1,SCHWARZ,1035,0,32,1835,1,435.232058,0.010352,0.010352,0.002073
2013,965,963,2,ROT,1037,0,8,1759,1,435.242410,0.041451,0.020725,0.002073
2014,963,959,4,SCHWARZ,1041,0,16,1839,1,435.283861,0.166147,0.041537,0.002073
2015,959,951,8,ROT,1049,0,28,1767,1,435.450008,0.667362,0.083420,0.002073
2016,951,935,16,SCHWARZ,1065,0,3,1855,1,436.117370,2.691903,0.168244,0.002073
2017,935,967,32,ROT,1033,1,5,1966,1,438.809273,13.142246,0.342246,0.068449
2018,967,968,1,ROT,1032,1,3,1967,1,451.951519,0.012410,0.010341,0.002068
2019,968,969,1,ROT,1031,1,5,1968,1,451.963929,0.012397,0.010331,0.002066
2020,969,968,1,ROT,1032,0,24,1768,1,451.976326,0.010320,0.010320,0.002066
2021,968,970,2,SCHWARZ,1030,1,33,1625,1,451.986646,0.049587,0.020661,0.004132
2022,970,969,1,SCHWARZ,1031,0,5,1856,1,452.036232,0.010309,0.010309,0.004132
2023,969,967,2,ROT,1033,0,4,1770,1,452.046542,0.041280,0.020640,0.004132
2024,967,963,4,SCHWARZ,1037,0,16,1860,1,452.087821,0.165460,0.041365,0.004132
2025,963,955,8,ROT,1045,0,13,1778,1,452.253281,0.664590,0.083074,0.004132
2026,955,939,16,SCHWARZ,1061,0,14,1876,1,452.917871,2.680628,0.167539,0.004132
2027,939,907,32,ROT,1093,0,2,1810,1,455.598500,10.905218,0.340788,0.004132
2028,907,843,64,SCHWARZ,1157,0,3,1940,1,466.503718,45.159868,0.705623,0.004132
2029,843,842,1,ROT,1158,0,0,1811,1,511.663586,0.011862,0.011862,0.004132
2030,842,844,2,SCHWARZ,1156,1,4,1627,1,511.675448,0.057007,0.023753,0.004751
2031,844,845,1,SCHWARZ,1155,1,24,1628,1,511.732455,0.014218,0.011848,0.002370
2032,845,846,1,SCHWARZ,1154,1,24,1629,1,511.746673,0.014201,0.011834,0.002367
2033,846,845,1,SCHWARZ,1155,0,18,1941,1,511.760874,0.011820,0.011820,0.002367
2034,845,847,2,ROT,1153,1,16,1970,1,511.772695,0.056805,0.023669,0.004734
2035,847,848,1,ROT,1152,1,27,1971,1,511.829499,0.014168,0.011806,0.002361
2036,848,849,1,ROT,1151,1,30,1972,1,511.843667,0.014151,0.011792,0.002358
2037,849,850,1,ROT,1150,1,27,1973,1,511.857818,0.014134,0.011779,0.002356
2038,850,849,1,ROT,1151,0,15,1812,1,511.871952,0.011765,0.011765,0.002356
2039,849,847,2,SCHWARZ,1153,0,5,1943,1,511.883717,0.047114,0.023557,0.002356
2040,847,851,4,ROT,1149,1,1,1977,1,511.930831,0.226682,0.047226,0.009445
2041,851,850,1,ROT,1150,0,33,1813,1,512.157514,0.011751,0.011751,0.009445
2042,850,852,2,SCHWARZ,1148,1,26,1631,1,512.169264,0.056471,0.023529,0.004706
2043,852,851,1,SCHWARZ,1149,0,7,1944,1,512.225735,0.011737,0.011737,0.004706
2044,851,849,2,ROT,1151,0,35,1815,1,512.237472,0.047004,0.023502,0.004706
2045,849,845,4,SCHWARZ,1155,0,5,1948,1,512.284476,0.188457,0.047114,0.004706
2046,845,853,8,ROT,1147,1,1,1985,1,512.472933,0.908876,0.094675,0.018935
2047,853,854,1,ROT,1146,1,19,1986,1,513.381808,0.014068,0.011723,0.002345
2048,854,853,1,ROT,1147,0,2,1816,1,513.395876,0.011710,0.011710,0.002345
2049,853,851,2,SCHWARZ,1149,0,27,1950,1,513.407586,0.046893,0.023447,0.002345
2050,851,847,4,ROT,1153,0,6,1820,1,513.454479,0.188014,0.047004,0.002345
2051,847,855,8,SCHWARZ,1145,1,28,1639,1,513.642493,0.906730,0.094451,0.018890
2052,855,854,1,SCHWARZ,1146,0,1,1951,1,514.549223,0.011696,0.011696,0.018890
2053,854,856,2,ROT,1144,1,32,1988,1,514.560919,0.056206,0.023419,0.004684
2054,856,857,1,ROT,1143,1,19,1989,1,514.617125,0.014019,0.011682,0.002336
2055,857,856,1,ROT,1144,0,11,1821,1,514.631144,0.011669,0.011669,0.002336
2056,856,854,2,SCHWARZ,1146,0,9,1953,1,514.642812,0.046729,0.023364,0.002336
2057,854,850,4,ROT,1150,0,2,1825,1,514.689541,0.187354,0.046838,0.002336
2058,850,858,8,SCHWARZ,1142,1,35,1647,1,514.876895,0.903529,0.094118,0.018824
2059,858,859,1,SCHWARZ,1141,1,29,1648,1,515.780424,0.013986,0.011655,0.002331
2060,859,860,1,SCHWARZ,1140,1,10,1649,1,515.794410,0.013970,0.011641,0.002328
2061,860,861,1,SCHWARZ,1139,1,11,1650,1,515.808380,0.013953,0.011628,0.002326
2062,861,860,1,SCHWARZ,1140,0,3,1954,1,515.822334,0.011614,0.011614,0.002326
2063,860,858,2,ROT,1142,0,28,1827,1,515.833948,0.046512,0.023256,0.002326
2064,858,854,4,SCHWARZ,1146,0,12,1958,1,515.880460,0.186480,0.046620,0.002326
2065,854,862,8,ROT,1138,1,21,1997,1,516.066940,0.899297,0.093677,0.018735
2066,862,861,1,ROT,1139,0,35,1828,1,516.966237,0.011601,0.011601,0.018735
2067,861,863,2,SCHWARZ,1137,1,28,1652,1,516.977838,0.055749,0.023229,0.004646
2068,863,862,1,SCHWARZ,1138,0,0,1959,1,517.033587,0.011587,0.011587,0.004646
2069,862,860,2,ROT,1140,0,35,1830,1,517.045175,0.046404,0.023202,0.004646
2070,860,864,4,SCHWARZ,1136,1,10,1656,1,517.091578,0.223256,0.046512,0.009302
2071,864,865,1,SCHWARZ,1135,1,24,1657,1,517.314834,0.013889,0.011574,0.002315
2072,865,866,1,SCHWARZ,1134,1,33,1658,1,517.328723,0.013873,0.011561,0.002312
2073,866,867,1,SCHWARZ,1133,1,4,1659,1,517.342596,0.013857,0.011547,0.002309
2074,867,868,1,SCHWARZ,1132,1,10,1660,1,517.356453,0.013841,0.011534,0.002307
2075,868,867,1,SCHWARZ,1133,0,1,1960,1,517.370294,0.011521,0.011521,0.002307
2076,867,869,2,ROT,1131,1,1,1999,1,517.381814,0.055363,0.023068,0.004614
2077,869,868,1,ROT,1132,0,20,1831,1,517.437178,0.011507,0.011507,0.004614
2078,868,866,2,SCHWARZ,1134,0,36,1962,1,517.448685,0.046083,0.023041,0.004614
2079,866,870,4,ROT,1130,1,14,2003,1,517.494768,0.221709,0.046189,0.009238
2080,870,869,1,ROT,1131,0,20,1832,1,517.716477,0.011494,0.011494,0.009238
2081,869,867,2,SCHWARZ,1133,0,14,1964,1,517.727971,0.046030,0.023015,0.009238
2082,867,863,4,ROT,1137,0,31,1836,1,517.774001,0.184544,0.046136,0.009238
2083,863,855,8,SCHWARZ,1145,0,36,1972,1,517.958546,0.741599,0.092700,0.009238
2084,855,871,16,ROT,1129,1,21,2019,1,518.700145,3.592982,0.187135,0.037427
2085,871,872,1,ROT,1128,1,19,2020,1,522.293127,0.013777,0.011481,0.002296
2086,872,871,1,ROT,1129,0,4,1837,1,522.306905,0.011468,0.011468,0.002296
2087,871,869,2,SCHWARZ,1131,0,5,1974,1,522.318372,0.045924,0.022962,0.002296
2088,869,865,4,ROT,1135,0,22,1841,1,522.364297,0.184120,0.046030,0.002296
2089,865,857,8,SCHWARZ,1143,0,19,1982,1,522.548416,0.739884,0.092486,0.002296
2090,857,841,16,ROT,1159,0,10,1857,1,523.288301,2.987165,0.186698,0.002296
2091,841,809,32,SCHWARZ,1191,0,34,2014,1,526.275465,12.175981,0.380499,0.002296
2092,809,745,64,ROT,1255,0,20,1921,1,538.451446,50.630408,0.791100,0.002296
2093,745,746,1,SCHWARZ,1254,1,35,1661,1,589.081854,0.016107,0.013423,0.002685
2094,746,745,1,SCHWARZ,1255,0,18,2015,1,589.097962,0.013405,0.013405,0.002685
2095,745,747,2,ROT,1253,1,9,2022,1,589.111366,0.064430,0.026846,0.005369
2096,747,748,1,ROT,1252,1,23,2023,1,589.175796,0.016064,0.013387,0.002677
2097,748,747,1,ROT,1253,0,33,1922,1,589.191860,0.013369,0.013369,0.002677
2098,747,749,2,SCHWARZ,1251,1,17,1663,1,589.205229,0.064257,0.026774,0.005355
2099,749,750,1,SCHWARZ,1250,1,8,1664,1,589.269486,0.016021,0.013351,0.002670
2100,750,751,1,SCHWARZ,1249,1,11,1665,1,589.285508,0.016000,0.013333,0.002667
2101,751,752,1,SCHWARZ,1248,1,10,1666,1,589.301508,0.015979,0.013316,0.002663
2102,752,753,1,SCHWARZ,1247,1,6,1667,1,589.317486,0.015957,0.013298,0.002660
2103,753,752,1,SCHWARZ,1248,0,30,2016,1,589.333444,0.013280,0.013280,0.002660
2104,752,750,2,ROT,1250,0,17,1924,1,589.346724,0.053191,0.026596,0.002660
2105,750,754,4,SCHWARZ,1246,1,15,1671,1,589.399915,0.256000,0.053333,0.010667
2106,754,755,1,SCHWARZ,1245,1,35,1672,1,589.655915,0.015915,0.013263,0.002653
2107,755,754,1,SCHWARZ,1246,0,3,2017,1,589.671830,0.013245,0.013245,0.002653
2108,754,756,2,ROT,1244,1,30,2025,1,589.685076,0.063660,0.026525,0.005305
2109,756,757,1,ROT,1243,1,21,2026,1,589.748736,0.015873,0.013228,0.002646
2110,757,756,1,ROT,1244,0,33,1925,1,589.764609,0.013210,0.013210,0.002646
2111,756,758,2,SCHWARZ,1242,1,29,1674,1,589.777819,0.063492,0.026455,0.005291
2112,758,759,1,SCHWARZ,1241,1,26,1675,1,589.841311,0.015831,0.013193,0.002639
2113,759,760,1,SCHWARZ,1240,1,15,1676,1,589.857142,0.015810,0.013175,0.002635
2114,760,759,1,SCHWARZ,1241,0,19,2018,1,589.872953,0.013158,0.013158,0.002635
2115,759,757,2,ROT,1243,0,11,1927,1,589.886110,0.052701,0.026350,0.002635
2116,757,761,4,SCHWARZ,1239,1,17,1680,1,589.938811,0.253633,0.052840,0.010568
2117,761,762,1,SCHWARZ,1238,1,4,1681,1,590.192444,0.015769,0.013141,0.002628
2118,762,763,1,SCHWARZ,1237,1,20,1682,1,590.208213,0.015748,0.013123,0.002625
2119,763,762,1,SCHWARZ,1238,0,34,2019,1,590.223961,0.013106,0.013106,0.002625
2120,762,760,2,ROT,1240,0,6,1929,1,590.237067,0.052493,0.026247,0.002625
2121,760,764,4,SCHWARZ,1236,1,22,1686,1,590.289560,0.252632,0.052632,0.010526
2122,764,765,1,SCHWARZ,1235,1,20,1687,1,590.542192,0.015707,0.013089,0.002618
2123,765,766,1,SCHWARZ,1234,1,20,1688,1,590.557899,0.015686,0.013072,0.002614
2124,766,767,1,SCHWARZ,1233,1,13,1689,1,590.573585,0.015666,0.013055,0.002611
2125,767,768,1,SCHWARZ,1232,1,35,1690,1,590.589251,0.015645,0.013038,0.002608
2126,768,767,1,SCHWARZ,1233,0,21,2020,1,590.604896,0.013021,0.013021,0.002608
2127,767,765,2,ROT,1235,0,28,1931,1,590.617917,0.052151,0.026076,0.002608
2128,765,761,4,SCHWARZ,1239,0,5,2024,1,590.670068,0.209150,0.052288,0.002608
2129,761,769,8,ROT,1231,1,12,2034,1,590.879219,1.009198,0.105125,0.021025
2130,769,768,1,ROT,1232,0,17,1932,1,591.888417,0.013004,0.013004,0.021025
2131,768,770,2,SCHWARZ,1230,1,20,1692,1,591.901421,0.062500,0.026042,0.005208
2132,770,769,1,SCHWARZ,1231,0,14,2025,1,591.963921,0.012987,0.012987,0.005208
2133,769,771,2,ROT,1229,1,1,2036,1,591.976908,0.062419,0.026008,0.005202
2134,771,770,1,ROT,1230,0,22,1933,1,592.039327,0.012970,0.012970,0.005202
2135,770,768,2,SCHWARZ,1232,0,19,2027,1,592.052297,0.051948,0.025974,0.005202
2136,768,772,4,ROT,1228,1,34,2040,1,592.104245,0.250000,0.052083,0.010417
2137,772,771,1,ROT,1229,0,11,1934,1,592.354245,0.012953,0.012953,0.010417
2138,771,769,2,SCHWARZ,1231,0,5,2029,1,592.367198,0.051881,0.025940,0.010417
2139,769,765,4,ROT,1235,0,17,1938,1,592.419079,0.208062,0.052016,0.010417
2140,765,757,8,SCHWARZ,1243,0,27,2037,1,592.627141,0.836601,0.104575,0.010417
2141,757,773,16,ROT,1227,1,18,2056,1,593.463743,4.058124,0.211361,0.042272
2142,773,772,1,ROT,1228,0,22,1939,1,597.521867,0.012937,0.012937,0.042272
2143,772,770,2,SCHWARZ,1230,0,23,2039,1,597.534804,0.051813,0.025907,0.042272
2144,770,766,4,ROT,1234,0,29,1943,1,597.586617,0.207792,0.051948,0.042272
2145,766,774,8,SCHWARZ,1226,1,28,1700,1,597.794409,1.002611,0.104439,0.020888
2146,774,773,1,SCHWARZ,1227,0,36,2040,1,598.797020,0.012920,0.012920,0.020888
2147,773,775,2,ROT,1225,1,18,2058,1,598.809940,0.062096,0.025873,0.005175
2148,775,776,1,ROT,1224,1,14,2059,1,598.872036,0.015484,0.012903,0.002581
2149,776,775,1,ROT,1225,0,17,1944,1,598.887520,0.012887,0.012887,0.002581
2150,775,777,2,SCHWARZ,1223,1,20,1702,1,598.900406,0.061935,0.025806,0.005161
2151,777,778,1,SCHWARZ,1222,1,33,1703,1,598.962342,0.015444,0.012870,0.002574
2152,778,779,1,SCHWARZ,1221,1,13,1704,1,598.977786,0.015424,0.012853,0.002571
2153,779,780,1,SCHWARZ,1220,1,26,1705,1,598.993210,0.015404,0.012837,0.002567
2154,780,781,1,SCHWARZ,1219,1,20,1706,1,599.008614,0.015385,0.012821,0.002564
2155,781,780,1,SCHWARZ,1220,0,7,2041,1,599.023999,0.012804,0.012804,0.002564
2156,780,782,2,ROT,1218,1,36,2061,1,599.036803,0.061538,0.025641,0.005128
2157,782,783,1,ROT,1217,1,19,2062,1,599.098341,0.015345,0.012788,0.002558
2158,783,782,1,ROT,1218,0,0,1945,1,599.113687,0.012771,0.012771,0.002558
2159,782,780,2,SCHWARZ,1220,0,12,2043,1,599.126458,0.051151,0.025575,0.002558
2160,780,784,4,ROT,1216,1,27,2066,1,599.177609,0.246154,0.051282,0.010256
2161,784,785,1,ROT,1215,1,27,2067,1,599.423763,0.015306,0.012755,0.002551
2162,785,784,1,ROT,1216,0,26,1946,1,599.439069,0.012739,0.012739,0.002551
2163,784,786,2,SCHWARZ,1214,1,20,1708,1,599.451808,0.061224,0.025510,0.005102
2164,786,787,1,SCHWARZ,1213,1,28,1709,1,599.513032,0.015267,0.012723,0.002545
2165,787,788,1,SCHWARZ,1212,1,4,1710,1,599.528300,0.015248,0.012706,0.002541
2166,788,789,1,SCHWARZ,1211,1,22,1711,1,599.543547,0.015228,0.012690,0.002538
2167,789,788,1,SCHWARZ,1212,0,36,2044,1,599.558776,0.012674,0.012674,0.002538
2168,788,786,2,ROT,1214,0,11,1948,1,599.571450,0.050761,0.025381,0.002538
2169,786,782,4,SCHWARZ,1218,0,32,2048,1,599.622211,0.203562,0.050891,0.002538
2170,782,790,8,ROT,1210,1,23,2075,1,599.825774,0.982097,0.102302,0.020460
2171,790,791,1,ROT,1209,1,7,2076,1,600.807871,0.015190,0.012658,0.002532
2172,791,792,1,ROT,1208,1,32,2077,1,600.823061,0.015171,0.012642,0.002528
2173,792,793,1,ROT,1207,1,5,2078,1,600.838232,0.015152,0.012626,0.002525
2174,793,792,1,ROT,1208,0,26,1949,1,600.853383,0.012610,0.012610,0.002525
2175,792,794,2,SCHWARZ,1206,1,13,1713,1,600.865993,0.060606,0.025253,0.005051
2176,794,793,1,SCHWARZ,1207,0,36,2049,1,600.926599,0.012594,0.012594,0.005051
2177,793,795,2,ROT,1205,1,12,2080,1,600.939194,0.060530,0.025221,0.005044
2178,795,796,1,ROT,1204,1,14,2081,1,600.999724,0.015094,0.012579,0.002516
2179,796,797,1,ROT,1203,1,19,2082,1,601.014818,0.015075,0.012563,0.002513
2180,797,798,1,ROT,1202,1,19,2083,1,601.029893,0.015056,0.012547,0.002509
2181,798,799,1,ROT,1201,1,3,2084,1,601.044950,0.015038,0.012531,0.002506
2182,799,800,1,ROT,1200,1,19,2085,1,601.059987,0.015019,0.012516,0.002503
2183,800,799,1,ROT,1201,0,26,1950,1,601.075006,0.012500,0.012500,0.002503
2184,799,797,2,SCHWARZ,1203,0,12,2051,1,601.087506,0.050063,0.025031,0.002503
2185,797,793,4,ROT,1207,0,0,1954,1,601.137569,0.200753,0.050188,0.002503
2186,793,801,8,SCHWARZ,1199,1,15,1721,1,601.338321,0.968474,0.100883,0.020177
2187,801,802,1,SCHWARZ,1198,1,10,1722,1,602.306796,0.014981,0.012484,0.002497
2188,802,803,1,SCHWARZ,1197,1,4,1723,1,602.321777,0.014963,0.012469,0.002494
2189,803,804,1,SCHWARZ,1196,1,24,1724,1,602.336739,0.014944,0.012453,0.002491
2190,804,805,1,SCHWARZ,1195,1,26,1725,1,602.351683,0.014925,0.012438,0.002488
2191,805,804,1,SCHWARZ,1196,0,12,2052,1,602.366609,0.012422,0.012422,0.002488
2192,804,806,2,ROT,1194,1,32,2087,1,602.379031,0.059701,0.024876,0.004975
2193,806,807,1,ROT,1193,1,14,2088,1,602.438733,0.014888,0.012407,0.002481
2194,807,808,1,ROT,1192,1,27,2089,1,602.453621,0.014870,0.012392,0.002478
2195,808,809,1,ROT,1191,1,34,2090,1,602.468491,0.014851,0.012376,0.002475
2196,809,808,1,ROT,1192,0,15,1955,1,602.483342,0.012361,0.012361,0.002475
2197,808,810,2,SCHWARZ,1190,1,31,1727,1,602.495703,0.059406,0.024752,0.004950
2198,810,809,1,SCHWARZ,1191,0,23,2053,1,602.555109,0.012346,0.012346,0.004950
2199,809,807,2,ROT,1193,0,35,1957,1,602.567455,0.049444,0.024722,0.004950
2200,807,811,4,SCHWARZ,1189,1,2,1731,1,602.616899,0.237918,0.049566,0.009913
2201,811,812,1,SCHWARZ,1188,1,28,1732,1,602.854817,0.014797,0.012330,0.002466
2202,812,813,1,SCHWARZ,1187,1,17,1733,1,602.869613,0.014778,0.012315,0.002463
2203,813,814,1,SCHWARZ,1186,1,31,1734,1,602.884392,0.014760,0.012300,0.002460
2204,814,815,1,SCHWARZ,1185,1,4,1735,1,602.899152,0.014742,0.012285,0.002457
2205,815,816,1,SCHWARZ,1184,1,29,1736,1,602.913894,0.014724,0.012270,0.002454
2206,816,815,1,SCHWARZ,1185,0,19,2054,1,602.928618,0.012255,0.012255,0.002454
2207,815,817,2,ROT,1183,1,9,2092,1,602.940873,0.058896,0.024540,0.004908
2208,817,818,1,ROT,1182,1,21,2093,1,602.999768,0.014688,0.012240,0.002448
2209,818,817,1,ROT,1183,0,10,1958,1,603.014456,0.012225,0.012225,0.002448
2210,817,815,2,SCHWARZ,1185,0,7,2056,1,603.026681,0.048960,0.024480,0.002448
2211,815,811,4,ROT,1189,0,28,1962,1,603.075641,0.196319,0.049080,0.002448
2212,811,803,8,SCHWARZ,1197,0,19,2064,1,603.271960,0.789149,0.098644,0.002448
2213,803,787,16,ROT,1213,0,8,1978,1,604.061109,3.188045,0.199253,0.002448
2214,787,755,32,SCHWARZ,1245,0,19,2096,1,607.249154,13.011436,0.406607,0.002448
2215,755,819,64,ROT,1181,1,30,2157,1,620.260590,65.101987,0.847682,0.169536
2216,819,818,1,ROT,1182,0,35,1979,1,685.362577,0.012210,0.012210,0.169536
2217,818,820,2,SCHWARZ,1180,1,11,1738,1,685.374787,0.058680,0.024450,0.004890
2218,820,819,1,SCHWARZ,1181,0,12,2097,1,685.433466,0.012195,0.012195,0.004890
2219,819,817,2,ROT,1183,0,26,1981,1,685.445662,0.048840,0.024420,0.004890
2220,817,821,4,SCHWARZ,1179,1,35,1742,1,685.494502,0.235006,0.048960,0.009792
2221,821,822,1,SCHWARZ,1178,1,31,1743,1,685.729508,0.014616,0.012180,0.002436
2222,822,821,1,SCHWARZ,1179,0,9,2098,1,685.744124,0.012165,0.012165,0.002436
2223,821,819,2,ROT,1181,0,4,1983,1,685.756289,0.048721,0.024361,0.002436
2224,819,823,4,SCHWARZ,1177,1,4,1747,1,685.805011,0.234432,0.048840,0.009768
2225,823,824,1,SCHWARZ,1176,1,31,1748,1,686.039443,0.014581,0.012151,0.002430
2226,824,823,1,SCHWARZ,1177,0,30,2099,1,686.054024,0.012136,0.012136,0.002430
2227,823,825,2,ROT,1175,1,9,2159,1,686.066160,0.058323,0.024301,0.004860
2228,825,826,1,ROT,1174,1,9,2160,1,686.124483,0.014545,0.012121,0.002424
2229,826,827,1,ROT,1173,1,1,2161,1,686.139028,0.014528,0.012107,0.002421
2230,827,826,1,ROT,1174,0,10,1984,1,686.153556,0.012092,0.012092,0.002421
2231,826,828,2,SCHWARZ,1172,1,35,1750,1,686.165648,0.058111,0.024213,0.004843
2232,828,829,1,SCHWARZ,1171,1,24,1751,1,686.223759,0.014493,0.012077,0.002415
2233,829,828,1,SCHWARZ,1172,0,12,2100,1,686.238252,0.012063,0.012063,0.002415
2234,828,826,2,ROT,1174,0,31,1986,1,686.250315,0.048309,0.024155,0.002415
2235,826,822,4,SCHWARZ,1178,0,27,2104,1,686.298624,0.193705,0.048426,0.002415
2236,822,814,8,ROT,1186,0,11,1994,1,686.492329,0.778589,0.097324,0.002415
2237,814,798,16,SCHWARZ,1202,0,27,2120,1,687.270917,3.144963,0.196560,0.002415
2238,798,830,32,ROT,1170,1,18,2193,1,690.415881,15.398496,0.401003,0.080201
2239,830,829,1,ROT,1171,0,29,1995,1,705.814377,0.012048,0.012048,0.080201
2240,829,827,2,SCHWARZ,1173,0,25,2122,1,705.826425,0.048251,0.024125,0.080201
2241,827,823,4,ROT,1177,0,26,1999,1,705.874676,0.193470,0.048368,0.080201
2242,823,831,8,SCHWARZ,1169,1,33,1759,1,706.068146,0.933171,0.097205,0.019441
2243,831,832,1,SCHWARZ,1168,1,22,1760,1,707.001318,0.014440,0.012034,0.002407
2244,832,833,1,SCHWARZ,1167,1,22,1761,1,707.015758,0.014423,0.012019,0.002404
2245,833,832,1,SCHWARZ,1168,0,16,2123,1,707.030181,0.012005,0.012005,0.002404
2246,832,830,2,ROT,1170,0,2,2001,1,707.042186,0.048077,0.024038,0.002404
2247,830,826,4,SCHWARZ,1174,0,12,2127,1,707.090263,0.192771,0.048193,0.002404
2248,826,818,8,ROT,1182,0,11,2009,1,707.283034,0.774818,0.096852,0.002404
2249,818,802,16,SCHWARZ,1198,0,18,2143,1,708.057852,3.129584,0.195599,0.002404
2250,802,770,32,ROT,1230,0,22,2041,1,711.187437,12.768080,0.399002,0.002404
2251,770,706,64,SCHWARZ,1294,0,19,2207,1,723.955516,53.194805,0.831169,0.002404
2252,706,705,1,ROT,1295,0,26,2042,1,777.150322,0.014164,0.014164,0.002404
2253,705,707,2,SCHWARZ,1293,1,26,1763,1,777.164486,0.068085,0.028369,0.005674
2254,707,708,1,SCHWARZ,1292,1,26,1764,1,777.232571,0.016973,0.014144,0.002829
2255,708,707,1,SCHWARZ,1293,0,34,2208,1,777.249544,0.014124,0.014124,0.002829
2256,707,705,2,ROT,1295,0,33,2044,1,777.263668,0.056577,0.028289,0.002829
2257,705,701,4,SCHWARZ,1299,0,16,2212,1,777.320246,0.226950,0.056738,0.002829
2258,701,709,8,ROT,1291,1,3,2201,1,777.547196,1.095578,0.114123,0.022825
2259,709,710,1,ROT,1290,1,30,2202,1,778.642774,0.016925,0.014104,0.002821
2260,710,709,1,ROT,1291,0,17,2045,1,778.659699,0.014085,0.014085,0.002821
2261,709,707,2,SCHWARZ,1293,0,0,2214,1,778.673783,0.056417,0.028209,0.002821
2262,707,711,4,ROT,1289,1,25,2206,1,778.730201,0.271570,0.056577,0.011315
2263,711,710,1,ROT,1290,0,28,2046,1,779.001771,0.014065,0.014065,0.011315
2264,710,712,2,SCHWARZ,1288,1,15,1766,1,779.015836,0.067606,0.028169,0.005634
2265,712,711,1,SCHWARZ,1289,0,9,2215,1,779.083441,0.014045,0.014045,0.005634
2266,711,713,2,ROT,1287,1,18,2208,1,779.097486,0.067511,0.028129,0.005626
2267,713,714,1,ROT,1286,1,16,2209,1,779.164997,0.016830,0.014025,0.002805
2268,714,715,1,ROT,1285,1,23,2210,1,779.181827,0.016807,0.014006,0.002801
2269,715,714,1,ROT,1286,0,24,2047,1,779.198634,0.013986,0.013986,0.002801
2270,714,712,2,SCHWARZ,1288,0,36,2217,1,779.212620,0.056022,0.028011,0.002801
2271,712,708,4,ROT,1292,0,22,2051,1,779.268642,0.224719,0.056180,0.002801
2272,708,700,8,SCHWARZ,1300,0,30,2225,1,779.493361,0.903955,0.112994,0.002801
2273,700,684,16,ROT,1316,0,2,2067,1,780.397316,3.657143,0.228571,0.002801
2274,684,652,32,SCHWARZ,1348,0,21,2257,1,784.054459,14.970760,0.467836,0.002801
2275,652,588,64,ROT,1412,0,4,2131,1,799.025219,62.822086,0.981595,0.002801
2276,588,587,1,SCHWARZ,1413,0,27,2258,1,861.847305,0.017007,0.017007,0.002801
2277,587,589,2,ROT,1411,1,9,2212,1,861.864312,0.081772,0.034072,0.006814
2278,589,590,1,ROT,1410,1,23,2213,1,861.946084,0.020374,0.016978,0.003396
2279,590,591,1,ROT,1409,1,23,2214,1,861.966457,0.020339,0.016949,0.003390
2280,591,590,1,ROT,1410,0,24,2132,1,861.986796,0.016920,0.016920,0.003390
2281,590,592,2,SCHWARZ,1408,1,35,1768,1,862.003717,0.081356,0.033898,0.006780
2282,592,593,1,SCHWARZ,1407,1,6,1769,1,862.085073,0.020270,0.016892,0.003378
2283,593,594,1,SCHWARZ,1406,1,4,1770,1,862.105343,0.020236,0.016863,0.003373
2284,594,595,1,SCHWARZ,1405,1,13,1771,1,862.125579,0.020202,0.016835,0.003367
2285,595,596,1,SCHWARZ,1404,1,15,1772,1,862.145781,0.020168,0.016807,0.003361
2286,596,597,1,SCHWARZ,1403,1,8,1773,1,862.165949,0.020134,0.016779,0.003356
2287,597,598,1,SCHWARZ,1402,1,8,1774,1,862.186083,0.020101,0.016750,0.003350
2288,598,597,1,SCHWARZ,1403,0,18,2259,1,862.206184,0.016722,0.016722,0.003350
2289,597,595,2,ROT,1405,0,35,2134,1,862.222906,0.067002,0.033501,0.003350
2290,595,599,4,SCHWARZ,1401,1,2,1778,1,862.289908,0.322689,0.067227,0.013445
2291,599,598,1,SCHWARZ,1402,0,36,2260,1,862.612597,0.016694,0.016694,0.013445
2292,598,600,2,ROT,1400,1,18,2216,1,862.629291,0.080268,0.033445,0.006689
2293,600,601,1,ROT,1399,1,27,2217,1,862.709559,0.020000,0.016667,0.003333
2294,601,602,1,ROT,1398,1,9,2218,1,862.729559,0.019967,0.016639,0.003328
2295,602,603,1,ROT,1397,1,32,2219,1,862.749526,0.019934,0.016611,0.003322
2296,603,604,1,ROT,1396,1,7,2220,1,862.769459,0.019900,0.016584,0.003317
2297,604,603,1,ROT,1397,0,0,2135,1,862.789360,0.016556,0.016556,0.003317
2298,603,605,2,SCHWARZ,1395,1,20,1780,1,862.805916,0.079602,0.033167,0.006633
2299,605,604,1,SCHWARZ,1396,0,25,2261,1,862.885518,0.016529,0.016529,0.006633
2300,604,602,2,ROT,1398,0,0,2137,1,862.902047,0.066225,0.033113,0.006633
2301,602,598,4,SCHWARZ,1402,0,21,2265,1,862.968272,0.265781,0.066445,0.006633
2302,598,590,8,ROT,1410,0,26,2145,1,863.234053,1.070234,0.133779,0.006633
2303,590,606,16,SCHWARZ,1394,1,22,1796,1,864.304287,5.206780,0.271186,0.054237
2304,606,605,1,SCHWARZ,1395,0,23,2266,1,869.511067,0.016502,0.016502,0.054237
2305,605,603,2,ROT,1397,0,26,2147,1,869.527568,0.066116,0.033058,0.054237
2306,603,607,4,SCHWARZ,1393,1,28,1800,1,869.593684,0.318408,0.066335,0.013267
2307,607,608,1,SCHWARZ,1392,1,28,1801,1,869.912092,0.019769,0.016474,0.003295
2308,608,609,1,SCHWARZ,1391,1,35,1802,1,869.931861,0.019737,0.016447,0.003289
2309,609,610,1,SCHWARZ,1390,1,4,1803,1,869.951598,0.019704,0.016420,0.003284
2310,610,611,1,SCHWARZ,1389,1,15,1804,1,869.971303,0.019672,0.016393,0.003279
2311,611,610,1,SCHWARZ,1390,0,32,2267,1,869.990975,0.016367,0.016367,0.003279
2312,610,612,2,ROT,1388,1,3,2222,1,870.007341,0.078689,0.032787,0.006557
2313,612,613,1,ROT,1387,1,25,2223,1,870.086030,0.019608,0.016340,0.003268
2314,613,612,1,ROT,1388,0,28,2148,1,870.105638,0.016313,0.016313,0.003268
2315,612,610,2,SCHWARZ,1390,0,32,2269,1,870.121951,0.065359,0.032680,0.003268
2316,610,606,4,ROT,1394,0,4,2152,1,870.187310,0.262295,0.065574,0.003268
2317,606,614,8,SCHWARZ,1386,1,33,1812,1,870.449605,1.267327,0.132013,0.026403
2318,614,615,1,SCHWARZ,1385,1,31,1813,1,871.716932,0.019544,0.016287,0.003257
2319,615,614,1,SCHWARZ,1386,0,23,2270,1,871.736476,0.016260,0.016260,0.003257
2320,614,612,2,ROT,1388,0,13,2154,1,871.752736,0.065147,0.032573,0.003257
2321,612,616,4,SCHWARZ,1384,1,22,1817,1,871.817883,0.313725,0.065359,0.013072
2322,616,617,1,SCHWARZ,1383,1,29,1818,1,872.131608,0.019481,0.016234,0.003247
2323,617,616,1,SCHWARZ,1384,0,30,2271,1,872.151089,0.016207,0.016207,0.003247
2324,616,614,2,ROT,1386,0,26,2156,1,872.167296,0.064935,0.032468,0.003247
2325,614,610,4,SCHWARZ,1390,0,9,2275,1,872.232231,0.260586,0.065147,0.003247
2326,610,602,8,ROT,1398,0,24,2164,1,872.492818,1.049180,0.131148,0.003247
2327,602,586,16,SCHWARZ,1414,0,25,2291,1,873.541998,4.252492,0.265781,0.003247
2328,586,618,32,ROT,1382,1,19,2255,1,877.794490,20.969283,0.546075,0.109215
2329,618,617,1,ROT,1383,0,8,2165,1,898.763773,0.016181,0.016181,0.109215
2330,617,619,2,SCHWARZ,1381,1,17,1820,1,898.779954,0.077796,0.032415,0.006483
2331,619,618,1,SCHWARZ,1382,0,19,2292,1,898.857750,0.016155,0.016155,0.006483
2332,618,616,2,ROT,1384,0,0,2167,1,898.873905,0.064725,0.032362,0.006483
2333,616,612,4,SCHWARZ,1388,0,34,2296,1,898.938630,0.259740,0.064935,0.006483
2334,612,620,8,ROT,1380,1,1,2263,1,899.198370,1.254902,0.130719,0.026144
2335,620,619,1,ROT,1381,0,33,2168,1,900.453272,0.016129,0.016129,0.026144
2336,619,617,2,SCHWARZ,1383,0,23,2298,1,900.469401,0.064620,0.032310,0.026144
2337,617,613,4,ROT,1387,0,33,2172,1,900.534022,0.259319,0.064830,0.026144
2338,613,605,8,SCHWARZ,1395,0,14,2306,1,900.793341,1.044046,0.130506,0.026144
2339,605,621,16,ROT,1379,1,12,2279,1,901.837387,5.077686,0.264463,0.052893
2340,621,622,1,ROT,1378,1,21,2280,1,906.915073,0.019324,0.016103,0.003221
2341,622,623,1,ROT,1377,1,23,2281,1,906.934396,0.019293,0.016077,0.003215
2342,623,622,1,ROT,1378,0,29,2173,1,906.953689,0.016051,0.016051,0.003215
2343,622,620,2,SCHWARZ,1380,0,1,2308,1,906.969740,0.064309,0.032154,0.003215
2344,620,624,4,ROT,1376,1,23,2285,1,907.034049,0.309677,0.064516,0.012903
2345,624,623,1,ROT,1377,0,31,2174,1,907.343726,0.016026,0.016026,0.012903
2346,623,621,2,SCHWARZ,1379,0,5,2310,1,907.359752,0.064205,0.032103,0.012903
2347,621,625,4,ROT,1375,1,14,2289,1,907.423957,0.309179,0.064412,0.012882
2348,625,624,1,ROT,1376,0,29,2175,1,907.733136,0.016000,0.016000,0.012882
2349,624,622,2,SCHWARZ,1378,0,21,2312,1,907.749136,0.064103,0.032051,0.012882
2350,622,626,4,ROT,1374,1,27,2293,1,907.813239,0.308682,0.064309,0.012862
2351,626,625,1,ROT,1375,0,33,2176,1,908.121920,0.015974,0.015974,0.012862
2352,625,627,2,SCHWARZ,1373,1,22,1822,1,908.137895,0.076800,0.032000,0.006400
2353,627,628,1,SCHWARZ,1372,1,17,1823,1,908.214695,0.019139,0.015949,0.003190
2354,628,627,1,SCHWARZ,1373,0,0,2313,1,908.233834,0.015924,0.015924,0.003190
2355,627,629,2,ROT,1371,1,27,2295,1,908.249757,0.076555,0.031898,0.006380
2356,629,630,1,ROT,1370,1,23,2296,1,908.326312,0.019078,0.015898,0.003180
2357,630,631,1,ROT,1369,1,23,2297,1,908.345390,0.019048,0.015873,0.003175
2358,631,630,1,ROT,1370,0,0,2177,1,908.364438,0.015848,0.015848,0.003175
2359,630,628,2,SCHWARZ,1372,0,19,2315,1,908.380286,0.063492,0.031746,0.003175
2360,628,624,4,ROT,1376,0,33,2181,1,908.443778,0.254777,0.063694,0.003175
2361,624,632,8,SCHWARZ,1368,1,4,1831,1,908.698555,1.230769,0.128205,0.025641
2362,632,631,1,SCHWARZ,1369,0,16,2316,1,909.929324,0.015823,0.015823,0.025641
2363,631,629,2,ROT,1371,0,0,2183,1,909.945147,0.063391,0.031696,0.025641
2364,629,633,4,SCHWARZ,1367,1,26,1835,1,910.008538,0.305246,0.063593,0.012719
2365,633,632,1,SCHWARZ,1368,0,19,2317,1,910.313785,0.015798,0.015798,0.012719
2366,632,634,2,ROT,1366,1,9,2299,1,910.329582,0.075949,0.031646,0.006329
2367,634,635,1,ROT,1365,1,36,2300,1,910.405532,0.018927,0.015773,0.003155
2368,635,634,1,ROT,1366,0,11,2184,1,910.424459,0.015748,0.015748,0.003155
2369,634,636,2,SCHWARZ,1364,1,17,1837,1,910.440207,0.075710,0.031546,0.006309
2370,636,637,1,SCHWARZ,1363,1,33,1838,1,910.515917,0.018868,0.015723,0.003145
2371,637,636,1,SCHWARZ,1364,0,19,2318,1,910.534785,0.015699,0.015699,0.003145
2372,636,638,2,ROT,1362,1,25,2302,1,910.550484,0.075472,0.031447,0.006289
2373,638,639,1,ROT,1361,1,23,2303,1,910.625955,0.018809,0.015674,0.003135
2374,639,640,1,ROT,1360,1,18,2304,1,910.644764,0.018779,0.015649,0.003130
2375,640,639,1,ROT,1361,0,26,2185,1,910.663543,0.015625,0.015625,0.003130
2376,639,637,2,SCHWARZ,1363,0,0,2320,1,910.679168,0.062598,0.031299,0.003130
2377,637,633,4,ROT,1367,0,35,2189,1,910.741766,0.251177,0.062794,0.003130
2378,633,625,8,SCHWARZ,1375,0,19,2328,1,910.992944,1.011058,0.126382,0.003130
2379,625,609,16,ROT,1391,0,24,2205,1,912.004002,4.096000,0.256000,0.003130
2380,609,641,32,SCHWARZ,1359,1,6,1870,1,916.100002,20.177340,0.525452,0.105090
2381,641,640,1,SCHWARZ,1360,0,23,2329,1,936.277342,0.015601,0.015601,0.105090
2382,640,638,2,ROT,1362,0,26,2207,1,936.292943,0.062500,0.031250,0.105090
2383,638,634,4,SCHWARZ,1366,0,1,2333,1,936.355443,0.250784,0.062696,0.105090
2384,634,642,8,ROT,1358,1,12,2312,1,936.606226,1.211356,0.126183,0.025237
2385,642,641,1,ROT,1359,0,0,2208,1,937.817583,0.015576,0.015576,0.025237
2386,641,639,2,SCHWARZ,1361,0,27,2335,1,937.833159,0.062402,0.031201,0.025237
2387,639,643,4,ROT,1357,1,25,2316,1,937.895562,0.300469,0.062598,0.012520
2388,643,644,1,ROT,1356,1,16,2317,1,938.196031,0.018663,0.015552,0.003110
2389,644,645,1,ROT,1355,1,21,2318,1,938.214694,0.018634,0.015528,0.003106
2390,645,646,1,ROT,1354,1,18,2319,1,938.233327,0.018605,0.015504,0.003101
2391,646,645,1,ROT,1355,0,2,2209,1,938.251932,0.015480,0.015480,0.003101
2392,645,643,2,SCHWARZ,1357,0,34,2337,1,938.267412,0.062016,0.031008,0.003101
2393,643,647,4,ROT,1353,1,36,2323,1,938.329427,0.298600,0.062208,0.012442
2394,647,648,1,ROT,1352,1,23,2324,1,938.628027,0.018547,0.015456,0.003091
2395,648,647,1,ROT,1353,0,2,2210,1,938.646575,0.015432,0.015432,0.003091
2396,647,645,2,SCHWARZ,1355,0,7,2339,1,938.662007,0.061824,0.030912,0.003091
2397,645,649,4,ROT,1351,1,36,2328,1,938.723831,0.297674,0.062016,0.012403
2398,649,650,1,ROT,1350,1,12,2329,1,939.021505,0.018490,0.015408,0.003082
2399,650,651,1,ROT,1349,1,19,2330,1,939.039995,0.018462,0.015385,0.003077
2400,651,650,1,ROT,1350,0,35,2211,1,939.058456,0.015361,0.015361,0.003077
2401,650,648,2,SCHWARZ,1352,0,36,2341,1,939.073817,0.061538,0.030769,0.003077
2402,648,652,4,ROT,1348,1,36,2334,1,939.135356,0.296296,0.061728,0.012346
2403,652,651,1,ROT,1349,0,31,2212,1,939.431652,0.015337,0.015337,0.012346
2404,651,653,2,SCHWARZ,1347,1,35,1872,1,939.446990,0.073733,0.030722,0.006144
2405,653,652,1,SCHWARZ,1348,0,12,2342,1,939.520722,0.015314,0.015314,0.006144
2406,652,654,2,ROT,1346,1,3,2336,1,939.536036,0.073620,0.030675,0.006135
2407,654,653,1,ROT,1347,0,31,2213,1,939.609656,0.015291,0.015291,0.006135
2408,653,651,2,SCHWARZ,1349,0,5,2344,1,939.624946,0.061256,0.030628,0.006135
2409,651,655,4,ROT,1345,1,19,2340,1,939.686202,0.294931,0.061444,0.012289
2410,655,656,1,ROT,1344,1,19,2341,1,939.981133,0.018321,0.015267,0.003053
2411,656,657,1,ROT,1343,1,14,2342,1,939.999454,0.018293,0.015244,0.003049
2412,657,656,1,ROT,1344,0,0,2214,1,940.017746,0.015221,0.015221,0.003049
2413,656,658,2,SCHWARZ,1342,1,20,1874,1,940.032967,0.073171,0.030488,0.006098
2414,658,657,1,SCHWARZ,1343,0,19,2345,1,940.106138,0.015198,0.015198,0.006098
2415,657,659,2,ROT,1341,1,32,2344,1,940.121335,0.073059,0.030441,0.006088
2416,659,660,1,ROT,1340,1,34,2345,1,940.194395,0.018209,0.015175,0.003035
2417,660,659,1,ROT,1341,0,8,2215,1,940.212604,0.015152,0.015152,0.003035
2418,659,661,2,SCHWARZ,1339,1,29,1876,1,940.227756,0.072838,0.030349,0.006070
2419,661,662,1,SCHWARZ,1338,1,31,1877,1,940.300593,0.018154,0.015129,0.003026
2420,662,663,1,SCHWARZ,1337,1,10,1878,1,940.318748,0.018127,0.015106,0.003021
2421,663,664,1,SCHWARZ,1336,1,6,1879,1,940.336874,0.018100,0.015083,0.003017
2422,664,665,1,SCHWARZ,1335,1,8,1880,1,940.354974,0.018072,0.015060,0.003012
2423,665,666,1,SCHWARZ,1334,1,2,1881,1,940.373046,0.018045,0.015038,0.003008
2424,666,667,1,SCHWARZ,1333,1,4,1882,1,940.391091,0.018018,0.015015,0.003003
2425,667,666,1,SCHWARZ,1334,0,19,2346,1,940.409109,0.014993,0.014993,0.003003
2426,666,664,2,ROT,1336,0,15,2217,1,940.424102,0.060060,0.030030,0.003003
2427,664,668,4,SCHWARZ,1332,1,4,1886,1,940.484162,0.289157,0.060241,0.012048
2428,668,669,1,SCHWARZ,1331,1,10,1887,1,940.773319,0.017964,0.014970,0.002994
2429,669,668,1,SCHWARZ,1332,0,16,2347,1,940.791283,0.014948,0.014948,0.002994
2430,668,670,2,ROT,1330,1,34,2347,1,940.806230,0.071856,0.029940,0.005988
2431,670,671,1,ROT,1329,1,1,2348,1,940.878087,0.017910,0.014925,0.002985
2432,671,670,1,ROT,1330,0,35,2218,1,940.895997,0.014903,0.014903,0.002985
2433,670,668,2,SCHWARZ,1332,0,36,2349,1,940.910900,0.059701,0.029851,0.002985
2434,668,672,4,ROT,1328,1,23,2352,1,940.970602,0.287425,0.059880,0.011976
2435,672,673,1,ROT,1327,1,9,2353,1,941.258027,0.017857,0.014881,0.002976
2436,673,674,1,ROT,1326,1,27,2354,1,941.275884,0.017831,0.014859,0.002972
2437,674,673,1,ROT,1327,0,28,2219,1,941.293715,0.014837,0.014837,0.002972
2438,673,671,2,SCHWARZ,1329,0,23,2351,1,941.308551,0.059435,0.029718,0.002972
2439,671,675,4,ROT,1325,1,23,2358,1,941.367987,0.286140,0.059613,0.011923
2440,675,676,1,ROT,1324,1,30,2359,1,941.654127,0.017778,0.014815,0.002963
2441,676,677,1,ROT,1323,1,21,2360,1,941.671905,0.017751,0.014793,0.002959
2442,677,678,1,ROT,1322,1,34,2361,1,941.689656,0.017725,0.014771,0.002954
2443,678,677,1,ROT,1323,0,11,2220,1,941.707381,0.014749,0.014749,0.002954
2444,677,679,2,SCHWARZ,1321,1,31,1889,1,941.722131,0.070901,0.029542,0.005908
2445,679,680,1,SCHWARZ,1320,1,31,1890,1,941.793032,0.017673,0.014728,0.002946
2446,680,679,1,SCHWARZ,1321,0,36,2352,1,941.810705,0.014706,0.014706,0.002946
2447,679,677,2,ROT,1323,0,8,2222,1,941.825411,0.058910,0.029455,0.002946
2448,677,681,4,SCHWARZ,1319,1,28,1894,1,941.884321,0.283604,0.059084,0.011817
2449,681,680,1,SCHWARZ,1320,0,14,2353,1,942.167925,0.014684,0.014684,0.011817
2450,680,678,2,ROT,1322,0,17,2224,1,942.182609,0.058824,0.029412,0.011817
2451,678,682,4,SCHWARZ,1318,1,2,1898,1,942.241433,0.283186,0.058997,0.011799
2452,682,681,1,SCHWARZ,1319,0,7,2354,1,942.524619,0.014663,0.014663,0.011799
2453,681,679,2,ROT,1321,0,8,2226,1,942.539281,0.058737,0.029369,0.011799
2454,679,683,4,SCHWARZ,1317,1,15,1902,1,942.598018,0.282769,0.058910,0.011782
2455,683,682,1,SCHWARZ,1318,0,30,2355,1,942.880787,0.014641,0.014641,0.011782
2456,682,684,2,ROT,1316,1,30,2363,1,942.895429,0.070381,0.029326,0.005865
2457,684,685,1,ROT,1315,1,1,2364,1,942.965810,0.017544,0.014620,0.002924
2458,685,684,1,ROT,1316,0,0,2227,1,942.983354,0.014599,0.014599,0.002924
2459,684,686,2,SCHWARZ,1314,1,2,1904,1,942.997952,0.070175,0.029240,0.005848
2460,686,687,1,SCHWARZ,1313,1,31,1905,1,943.068128,0.017493,0.014577,0.002915
2461,687,686,1,SCHWARZ,1314,0,14,2356,1,943.085620,0.014556,0.014556,0.002915
2462,686,684,2,ROT,1316,0,22,2229,1,943.100176,0.058309,0.029155,0.002915
2463,684,680,4,SCHWARZ,1320,0,21,2360,1,943.158485,0.233918,0.058480,0.002915
2464,680,672,8,ROT,1328,0,24,2237,1,943.392404,0.941176,0.117647,0.002915
2465,672,688,16,SCHWARZ,1312,1,8,1921,1,944.333580,4.571429,0.238095,0.047619
2466,688,687,1,SCHWARZ,1313,0,25,2361,1,948.905009,0.014535,0.014535,0.047619
2467,687,689,2,ROT,1311,1,34,2366,1,948.919543,0.069869,0.029112,0.005822
2468,689,688,1,ROT,1312,0,29,2238,1,948.989412,0.014514,0.014514,0.005822
2469,688,686,2,SCHWARZ,1314,0,25,2363,1,949.003926,0.058140,0.029070,0.005822
2470,686,690,4,ROT,1310,1,23,2370,1,949.062066,0.279883,0.058309,0.011662
2471,690,689,1,ROT,1311,0,13,2239,1,949.341949,0.014493,0.014493,0.011662
2472,689,687,2,SCHWARZ,1313,0,0,2365,1,949.356442,0.058055,0.029028,0.011662
2473,687,691,4,ROT,1309,1,23,2374,1,949.414497,0.279476,0.058224,0.011645
2474,691,690,1,ROT,1310,0,0,2240,1,949.693973,0.014472,0.014472,0.011645
2475,690,688,2,SCHWARZ,1312,0,9,2367,1,949.708445,0.057971,0.028986,0.011645
2476,688,684,4,ROT,1316,0,22,2244,1,949.766416,0.232558,0.058140,0.011645
2477,684,676,8,SCHWARZ,1324,0,9,2375,1,949.998974,0.935673,0.116959,0.011645
2478,676,692,16,ROT,1308,1,36,2390,1,950.934647,4.544379,0.236686,0.047337
2479,692,693,1,ROT,1307,1,16,2391,1,955.479025,0.017341,0.014451,0.002890
2480,693,692,1,ROT,1308,0,29,2245,1,955.496366,0.014430,0.014430,0.002890
2481,692,690,2,SCHWARZ,1310,0,9,2377,1,955.510796,0.057803,0.028902,0.002890
2482,690,694,4,ROT,1306,1,14,2395,1,955.568600,0.278261,0.057971,0.011594
2483,694,693,1,ROT,1307,0,28,2246,1,955.846861,0.014409,0.014409,0.011594
2484,693,691,2,SCHWARZ,1309,0,0,2379,1,955.861270,0.057720,0.028860,0.011594
2485,691,695,4,ROT,1305,1,1,2399,1,955.918990,0.277858,0.057887,0.011577
2486,695,694,1,ROT,1306,0,2,2247,1,956.196848,0.014388,0.014388,0.011577
2487,694,696,2,SCHWARZ,1304,1,22,1923,1,956.211237,0.069164,0.028818,0.005764
2488,696,697,1,SCHWARZ,1303,1,29,1924,1,956.280401,0.017241,0.014368,0.002874
2489,697,696,1,SCHWARZ,1304,0,1,2380,1,956.297642,0.014347,0.014347,0.002874
2490,696,698,2,ROT,1302,1,7,2401,1,956.311989,0.068966,0.028736,0.005747
2491,698,699,1,ROT,1301,1,27,2402,1,956.380955,0.017192,0.014327,0.002865
2492,699,700,1,ROT,1300,1,16,2403,1,956.398147,0.017167,0.014306,0.002861
2493,700,701,1,ROT,1299,1,36,2404,1,956.415314,0.017143,0.014286,0.002857
2494,701,700,1,ROT,1300,0,15,2248,1,956.432457,0.014265,0.014265,0.002857
2495,700,698,2,SCHWARZ,1302,0,34,2382,1,956.446722,0.057143,0.028571,0.002857
2496,698,702,4,ROT,1298,1,7,2408,1,956.503865,0.275072,0.057307,0.011461
2497,702,703,1,ROT,1297,1,16,2409,1,956.778937,0.017094,0.014245,0.002849
2498,703,702,1,ROT,1298,0,4,2249,1,956.796031,0.014225,0.014225,0.002849
2499,702,704,2,SCHWARZ,1296,1,6,1926,1,956.810256,0.068376,0.028490,0.005698
2500,704,705,1,SCHWARZ,1295,1,11,1927,1,956.878632,0.017045,0.014205,0.002841
2501,705,706,1,SCHWARZ,1294,1,26,1928,1,956.895677,0.017021,0.014184,0.002837
2502,706,705,1,SCHWARZ,1295,0,18,2383,1,956.912699,0.014164,0.014164,0.002837
2503,705,707,2,ROT,1293,1,36,2411,1,956.926863,0.068085,0.028369,0.005674
2504,707,708,1,ROT,1292,1,5,2412,1,956.994948,0.016973,0.014144,0.002829
2505,708,707,1,ROT,1293,0,29,2250,1,957.011921,0.014124,0.014124,0.002829
2506,707,705,2,SCHWARZ,1295,0,34,2385,1,957.026045,0.056577,0.028289,0.002829
2507,705,701,4,ROT,1299,0,4,2254,1,957.082622,0.226950,0.056738,0.002829
2508,701,693,8,SCHWARZ,1307,0,30,2393,1,957.309573,0.912981,0.114123,0.002829
2509,693,709,16,ROT,1291,1,3,2428,1,958.222554,4.432900,0.230880,0.046176
2510,709,708,1,ROT,1292,0,26,2255,1,962.655455,0.014104,0.014104,0.046176
2511,708,706,2,SCHWARZ,1294,0,7,2395,1,962.669559,0.056497,0.028249,0.046176
2512,706,710,4,ROT,1290,1,32,2432,1,962.726056,0.271955,0.056657,0.011331
2513,710,711,1,ROT,1289,1,32,2433,1,962.998011,0.016901,0.014085,0.002817
2514,711,710,1,ROT,1290,0,4,2256,1,963.014912,0.014065,0.014065,0.002817
2515,710,712,2,SCHWARZ,1288,1,28,1930,1,963.028977,0.067606,0.028169,0.005634
2516,712,711,1,SCHWARZ,1289,0,34,2396,1,963.096583,0.014045,0.014045,0.005634
2517,711,713,2,ROT,1287,1,18,2435,1,963.110628,0.067511,0.028129,0.005626
2518,713,714,1,ROT,1286,1,27,2436,1,963.178138,0.016830,0.014025,0.002805
2519,714,713,1,ROT,1287,0,15,2257,1,963.194968,0.014006,0.014006,0.002805
2520,713,711,2,SCHWARZ,1289,0,0,2398,1,963.208974,0.056101,0.028050,0.002805
2521,711,715,4,ROT,1285,1,36,2440,1,963.265075,0.270042,0.056259,0.011252
2522,715,716,1,ROT,1284,1,27,2441,1,963.535117,0.016783,0.013986,0.002797
2523,716,715,1,ROT,1285,0,26,2258,1,963.551900,0.013966,0.013966,0.002797
2524,715,717,2,SCHWARZ,1283,1,31,1932,1,963.565867,0.067133,0.027972,0.005594
2525,717,718,1,SCHWARZ,1282,1,24,1933,1,963.633000,0.016736,0.013947,0.002789
2526,718,717,1,SCHWARZ,1283,0,34,2399,1,963.649736,0.013928,0.013928,0.002789
2527,717,715,2,ROT,1285,0,26,2260,1,963.663664,0.055788,0.027894,0.002789
2528,715,711,4,SCHWARZ,1289,0,18,2403,1,963.719452,0.223776,0.055944,0.002789
2529,711,703,8,ROT,1297,0,13,2268,1,963.943228,0.900141,0.112518,0.002789
2530,703,687,16,SCHWARZ,1313,0,27,2419,1,964.843369,3.641536,0.227596,0.002789
2531,687,655,32,ROT,1345,0,15,2300,1,968.484905,14.905386,0.465793,0.002789
2532,655,591,64,SCHWARZ,1409,0,27,2483,1,983.390291,62.534351,0.977099,0.002789
2533,591,590,1,ROT,1410,0,4,2301,2,45.924642,0.016920,0.016920,0.002789
2534,590,592,2,SCHWARZ,1408,1,17,1935,2,45.941562,0.081356,0.033898,0.006780
2535,592,591,1,SCHWARZ,1409,0,36,2484,2,46.022918,0.016892,0.016892,0.006780
2536,591,593,2,ROT,1407,1,34,2443,2,46.039810,0.081218,0.033841,0.006768
2537,593,592,1,ROT,1408,0,0,2302,2,46.121028,0.016863,0.016863,0.006768
2538,592,594,2,SCHWARZ,1406,1,33,1937,2,46.137892,0.081081,0.033784,0.006757
2539,594,593,1,SCHWARZ,1407,0,12,2485,2,46.218973,0.016835,0.016835,0.006757
2540,593,591,2,ROT,1409,0,4,2304,2,46.235808,0.067454,0.033727,0.006757
2541,591,595,4,SCHWARZ,1405,1,33,1941,2,46.303262,0.324873,0.067682,0.013536
2542,595,596,1,SCHWARZ,1404,1,31,1942,2,46.628135,0.020168,0.016807,0.003361
2543,596,595,1,SCHWARZ,1405,0,5,2486,2,46.648303,0.016779,0.016779,0.003361
2544,595,593,2,ROT,1407,0,8,2306,2,46.665081,0.067227,0.033613,0.003361
2545,593,589,4,SCHWARZ,1411,0,14,2490,2,46.732308,0.269815,0.067454,0.003361
2546,589,597,8,ROT,1403,1,3,2451,2,47.002123,1.303905,0.135823,0.027165
2547,597,596,1,ROT,1404,0,33,2307,2,48.306028,0.016750,0.016750,0.027165
2548,596,598,2,SCHWARZ,1402,1,22,1944,2,48.322778,0.080537,0.033557,0.006711
2549,598,597,1,SCHWARZ,1403,0,16,2491,2,48.403315,0.016722,0.016722,0.006711
2550,597,599,2,ROT,1401,1,7,2453,2,48.420037,0.080402,0.033501,0.006700
2551,599,598,1,ROT,1402,0,22,2308,2,48.500439,0.016694,0.016694,0.006700
2552,598,596,2,SCHWARZ,1404,0,19,2493,2,48.517134,0.066890,0.033445,0.006700
2553,596,592,4,ROT,1408,0,22,2312,2,48.584023,0.268456,0.067114,0.006700
2554,592,584,8,SCHWARZ,1416,0,12,2501,2,48.852480,1.081081,0.135135,0.006700
2555,584,568,16,ROT,1432,0,35,2328,2,49.933561,4.383562,0.273973,0.006700
2556,568,600,32,SCHWARZ,1400,1,29,1976,2,54.317123,21.633803,0.563380,0.112676
2557,600,599,1,SCHWARZ,1401,0,5,2502,2,75.950925,0.016667,0.016667,0.112676
2558,599,601,2,ROT,1399,1,19,2455,2,75.967592,0.080134,0.033389,0.006678
2559,601,600,1,ROT,1400,0,24,2329,2,76.047726,0.016639,0.016639,0.006678
2560,600,598,2,SCHWARZ,1402,0,34,2504,2,76.064365,0.066667,0.033333,0.006678
2561,598,594,4,ROT,1406,0,15,2333,2,76.131031,0.267559,0.066890,0.006678
2562,594,586,8,SCHWARZ,1414,0,30,2512,2,76.398590,1.077441,0.134680,0.006678
2563,586,570,16,ROT,1430,0,31,2349,2,77.476031,4.368601,0.273038,0.006678
2564,570,538,32,SCHWARZ,1462,0,23,2544,2,81.844631,17.964912,0.561404,0.006678
2565,538,474,64,ROT,1526,0,8,2413,2,99.809544,76.133829,1.189591,0.006678
2566,474,475,1,SCHWARZ,1525,1,8,1977,2,175.943373,0.025316,0.021097,0.004219
2567,475,474,1,SCHWARZ,1526,0,12,2545,2,175.968689,0.021053,0.021053,0.004219
2568,474,476,2,ROT,1524,1,16,2457,2,175.989742,0.101266,0.042194,0.008439
2569,476,477,1,ROT,1523,1,36,2458,2,176.091008,0.025210,0.021008,0.004202
2570,477,476,1,ROT,1524,0,20,2414,2,176.116218,0.020964,0.020964,0.004202
2571,476,474,2,SCHWARZ,1526,0,18,2547,2,176.137182,0.084034,0.042017,0.004202
2572,474,470,4,ROT,1530,0,15,2418,2,176.221216,0.337553,0.084388,0.004202
2573,470,478,8,SCHWARZ,1522,1,28,1985,2,176.558768,1.634043,0.170213,0.034043
2574,478,477,1,SCHWARZ,1523,0,32,2548,2,178.192811,0.020921,0.020921,0.034043
2575,477,475,2,ROT,1525,0,31,2420,2,178.213732,0.083857,0.041929,0.034043
2576,475,479,4,SCHWARZ,1521,1,28,1989,2,178.297589,0.404211,0.084211,0.016842
2577,479,478,1,SCHWARZ,1522,0,34,2549,2,178.701800,0.020877,0.020877,0.016842
2578,478,480,2,ROT,1520,1,19,2460,2,178.722676,0.100418,0.041841,0.008368
2579,480,481,1,ROT,1519,1,12,2461,2,178.823095,0.025000,0.020833,0.004167
2580,481,482,1,ROT,1518,1,27,2462,2,178.848095,0.024948,0.020790,0.004158
2581,482,483,1,ROT,1517,1,14,2463,2,178.873043,0.024896,0.020747,0.004149
2582,483,482,1,ROT,1518,0,28,2421,2,178.897939,0.020704,0.020704,0.004149
2583,482,480,2,SCHWARZ,1520,0,14,2551,2,178.918643,0.082988,0.041494,0.004149
2584,480,484,4,ROT,1516,1,1,2467,2,179.001631,0.400000,0.083333,0.016667
2585,484,485,1,ROT,1515,1,18,2468,2,179.401631,0.024793,0.020661,0.004132
2586,485,484,1,ROT,1516,0,2,2422,2,179.426424,0.020619,0.020619,0.004132
2587,484,482,2,SCHWARZ,1518,0,30,2553,2,179.447042,0.082645,0.041322,0.004132
2588,482,478,4,ROT,1522,0,22,2426,2,179.529687,0.331950,0.082988,0.004132
2589,478,486,8,SCHWARZ,1514,1,20,1997,2,179.861637,1.606695,0.167364,0.033473
2590,486,485,1,SCHWARZ,1515,0,19,2554,2,181.468332,0.020576,0.020576,0.033473
2591,485,487,2,ROT,1513,1,12,2470,2,181.488908,0.098969,0.041237,0.008247
2592,487,488,1,ROT,1512,1,9,2471,2,181.587877,0.024641,0.020534,0.004107
2593,488,487,1,ROT,1513,0,13,2427,2,181.612518,0.020492,0.020492,0.004107
2594,487,489,2,SCHWARZ,1511,1,15,1999,2,181.633010,0.098563,0.041068,0.008214
2595,489,490,1,SCHWARZ,1510,1,13,2000,2,181.731572,0.024540,0.020450,0.004090
2596,490,491,1,SCHWARZ,1509,1,17,2001,2,181.756112,0.024490,0.020408,0.004082
2597,491,490,1,SCHWARZ,1510,0,27,2555,2,181.780602,0.020367,0.020367,0.004082
2598,490,488,2,ROT,1512,0,15,2429,2,181.800968,0.081633,0.040816,0.004082
2599,488,492,4,SCHWARZ,1508,1,4,2005,2,181.882601,0.393443,0.081967,0.016393
2600,492,493,1,SCHWARZ,1507,1,24,2006,2,182.276044,0.024390,0.020325,0.004065
2601,493,492,1,SCHWARZ,1508,0,30,2556,2,182.300434,0.020284,0.020284,0.004065
2602,492,494,2,ROT,1506,1,25,2473,2,182.320718,0.097561,0.040650,0.008130
2603,494,495,1,ROT,1505,1,30,2474,2,182.418279,0.024291,0.020243,0.004049
2604,495,496,1,ROT,1504,1,14,2475,2,182.442570,0.024242,0.020202,0.004040
2605,496,495,1,ROT,1505,0,2,2430,2,182.466813,0.020161,0.020161,0.004040
2606,495,497,2,SCHWARZ,1503,1,8,2008,2,182.486974,0.096970,0.040404,0.008081
2607,497,498,1,SCHWARZ,1502,1,2,2009,2,182.583944,0.024145,0.020121,0.004024
2608,498,499,1,SCHWARZ,1501,1,29,2010,2,182.608089,0.024096,0.020080,0.004016
2609,499,498,1,SCHWARZ,1502,0,5,2557,2,182.632185,0.020040,0.020040,0.004016
2610,498,500,2,ROT,1500,1,25,2477,2,182.652225,0.096386,0.040161,0.008032
2611,500,501,1,ROT,1499,1,21,2478,2,182.748611,0.024000,0.020000,0.004000
2612,501,502,1,ROT,1498,1,12,2479,2,182.772611,0.023952,0.019960,0.003992
2613,502,503,1,ROT,1497,1,36,2480,2,182.796563,0.023904,0.019920,0.003984
2614,503,504,1,ROT,1496,1,32,2481,2,182.820467,0.023857,0.019881,0.003976
2615,504,505,1,ROT,1495,1,30,2482,2,182.844324,0.023810,0.019841,0.003968
2616,505,504,1,ROT,1496,0,4,2431,2,182.868134,0.019802,0.019802,0.003968
2617,504,502,2,SCHWARZ,1498,0,25,2559,2,182.887936,0.079365,0.039683,0.003968
2618,502,506,4,ROT,1494,1,32,2486,2,182.967301,0.382470,0.079681,0.015936
2619,506,507,1,ROT,1493,1,34,2487,2,183.349771,0.023715,0.019763,0.003953
2620,507,508,1,ROT,1492,1,18,2488,2,183.373486,0.023669,0.019724,0.003945
2621,508,509,1,ROT,1491,1,18,2489,2,183.397155,0.023622,0.019685,0.003937
2622,509,510,1,ROT,1490,1,19,2490,2,183.420777,0.023576,0.019646,0.003929
2623,510,511,1,ROT,1489,1,5,2491,2,183.444352,0.023529,0.019608,0.003922
2624,511,510,1,ROT,1490,0,31,2432,2,183.467882,0.019569,0.019569,0.003922
2625,510,508,2,SCHWARZ,1492,0,5,2561,2,183.487451,0.078431,0.039216,0.003922
2626,508,512,4,ROT,1488,1,25,2495,2,183.565883,0.377953,0.078740,0.015748
2627,512,511,1,ROT,1489,0,15,2433,2,183.943835,0.019531,0.019531,0.015748
2628,511,513,2,SCHWARZ,1487,1,15,2012,2,183.963367,0.093933,0.039139,0.007828
2629,513,512,1,SCHWARZ,1488,0,3,2562,2,184.057300,0.019493,0.019493,0.007828
2630,512,510,2,ROT,1490,0,35,2435,2,184.076793,0.078125,0.039062,0.007828
2631,510,506,4,SCHWARZ,1494,0,27,2566,2,184.154918,0.313725,0.078431,0.007828
2632,506,498,8,ROT,1502,0,11,2443,2,184.468644,1.264822,0.158103,0.007828
2633,498,482,16,SCHWARZ,1518,0,16,2582,2,185.733466,5.140562,0.321285,0.007828
2634,482,450,32,ROT,1550,0,35,2475,2,190.874028,21.244813,0.663900,0.007828
2635,450,514,64,SCHWARZ,1486,1,35,2076,2,212.118842,109.226667,1.422222,0.284444
2636,514,513,1,SCHWARZ,1487,0,23,2583,2,321.345508,0.019455,0.019455,0.284444
2637,513,515,2,ROT,1485,1,18,2497,2,321.364964,0.093567,0.038986,0.007797
2638,515,516,1,ROT,1484,1,34,2498,2,321.458531,0.023301,0.019417,0.003883
2639,516,517,1,ROT,1483,1,21,2499,2,321.481832,0.023256,0.019380,0.003876
2640,517,516,1,ROT,1484,0,8,2476,2,321.505088,0.019342,0.019342,0.003876
2641,516,514,2,SCHWARZ,1486,0,0,2585,2,321.524430,0.077519,0.038760,0.003876
2642,514,510,4,ROT,1490,0,10,2480,2,321.601949,0.311284,0.077821,0.003876
2643,510,518,8,SCHWARZ,1482,1,29,2084,2,321.913234,1.505882,0.156863,0.031373
2644,518,519,1,SCHWARZ,1481,1,24,2085,2,323.419116,0.023166,0.019305,0.003861
2645,519,518,1,SCHWARZ,1482,0,0,2586,2,323.442282,0.019268,0.019268,0.003861
2646,518,516,2,ROT,1484,0,31,2482,2,323.461550,0.077220,0.038610,0.003861
2647,516,512,4,SCHWARZ,1488,0,21,2590,2,323.538770,0.310078,0.077519,0.003861
2648,512,520,8,ROT,1480,1,18,2507,2,323.848847,1.500000,0.156250,0.031250
2649,520,519,1,ROT,1481,0,29,2483,2,325.348847,0.019231,0.019231,0.031250
2650,519,521,2,SCHWARZ,1479,1,20,2087,2,325.368078,0.092486,0.038536,0.007707
2651,521,522,1,SCHWARZ,1478,1,8,2088,2,325.460564,0.023033,0.019194,0.003839
2652,522,523,1,SCHWARZ,1477,1,2,2089,2,325.483596,0.022989,0.019157,0.003831
2653,523,524,1,SCHWARZ,1476,1,17,2090,2,325.506585,0.022945,0.019120,0.003824
2654,524,523,1,SCHWARZ,1477,0,1,2591,2,325.529529,0.019084,0.019084,0.003824
2655,523,521,2,ROT,1479,0,29,2485,2,325.548613,0.076482,0.038241,0.003824
2656,521,525,4,SCHWARZ,1475,1,35,2094,2,325.625095,0.368522,0.076775,0.015355
2657,525,524,1,SCHWARZ,1476,0,30,2592,2,325.993617,0.019048,0.019048,0.015355
2658,524,522,2,ROT,1478,0,35,2487,2,326.012665,0.076336,0.038168,0.015355
2659,522,526,4,SCHWARZ,1474,1,31,2098,2,326.089001,0.367816,0.076628,0.015326
2660,526,527,1,SCHWARZ,1473,1,33,2099,2,326.456817,0.022814,0.019011,0.003802
2661,527,526,1,SCHWARZ,1474,0,19,2593,2,326.479631,0.018975,0.018975,0.003802
2662,526,524,2,ROT,1476,0,24,2489,2,326.498606,0.076046,0.038023,0.003802
2663,524,520,4,SCHWARZ,1480,0,21,2597,2,326.574651,0.305344,0.076336,0.003802
2664,520,528,8,ROT,1472,1,23,2515,2,326.879995,1.476923,0.153846,0.030769
2665,528,527,1,ROT,1473,0,4,2490,2,328.356918,0.018939,0.018939,0.030769
2666,527,529,2,SCHWARZ,1471,1,24,2101,2,328.375857,0.091082,0.037951,0.007590
2667,529,528,1,SCHWARZ,1472,0,23,2598,2,328.466939,0.018904,0.018904,0.007590
2668,528,526,2,ROT,1474,0,29,2492,2,328.485843,0.075758,0.037879,0.007590
2669,526,522,4,SCHWARZ,1478,0,23,2602,2,328.561600,0.304183,0.076046,0.007590
2670,522,530,8,ROT,1470,1,1,2523,2,328.865783,1.471264,0.153257,0.030651
2671,530,531,1,ROT,1469,1,32,2524,2,330.337047,0.022642,0.018868,0.003774
2672,531,532,1,ROT,1468,1,18,2525,2,330.359689,0.022599,0.018832,0.003766
2673,532,531,1,ROT,1469,0,8,2493,2,330.382287,0.018797,0.018797,0.003766
2674,531,533,2,SCHWARZ,1467,1,10,2103,2,330.401084,0.090395,0.037665,0.007533
2675,533,532,1,SCHWARZ,1468,0,16,2603,2,330.491480,0.018762,0.018762,0.007533
2676,532,534,2,ROT,1466,1,32,2527,2,330.510242,0.090226,0.037594,0.007519
2677,534,533,1,ROT,1467,0,31,2494,2,330.600467,0.018727,0.018727,0.007519
2678,533,535,2,SCHWARZ,1465,1,26,2105,2,330.619194,0.090056,0.037523,0.007505
2679,535,534,1,SCHWARZ,1466,0,16,2604,2,330.709250,0.018692,0.018692,0.007505
2680,534,532,2,ROT,1468,0,6,2496,2,330.727942,0.074906,0.037453,0.007505
2681,532,536,4,SCHWARZ,1464,1,15,2109,2,330.802848,0.360902,0.075188,0.015038
2682,536,537,1,SCHWARZ,1463,1,33,2110,2,331.163750,0.022388,0.018657,0.003731
2683,537,536,1,SCHWARZ,1464,0,5,2605,2,331.186138,0.018622,0.018622,0.003731
2684,536,534,2,ROT,1466,0,26,2498,2,331.204760,0.074627,0.037313,0.003731
2685,534,530,4,SCHWARZ,1470,0,30,2609,2,331.279387,0.299625,0.074906,0.003731
2686,530,522,8,ROT,1478,0,22,2506,2,331.579013,1.207547,0.150943,0.003731
2687,522,506,16,SCHWARZ,1494,0,19,2625,2,332.786560,4.904215,0.306513,0.003731
2688,506,474,32,ROT,1526,0,15,2538,2,337.690774,20.237154,0.632411,0.003731
2689,474,410,64,SCHWARZ,1590,0,21,2689,2,357.927929,86.413502,1.350211,0.003731
2690,410,409,1,ROT,1591,0,33,2539,2,444.341431,0.024390,0.024390,0.003731
2691,409,407,2,SCHWARZ,1593,0,32,2691,2,444.365821,0.097800,0.048900,0.003731
2692,407,403,4,ROT,1597,0,17,2543,2,444.463620,0.393120,0.098280,0.003731
2693,403,411,8,SCHWARZ,1589,1,4,2118,2,444.856741,1.905707,0.198511,0.039702
2694,411,412,1,SCHWARZ,1588,1,31,2119,2,446.762448,0.029197,0.024331,0.004866
2695,412,413,1,SCHWARZ,1587,1,33,2120,2,446.791645,0.029126,0.024272,0.004854
2696,413,412,1,SCHWARZ,1588,0,19,2692,2,446.820771,0.024213,0.024213,0.004854
2697,412,414,2,ROT,1586,1,16,2529,2,446.844984,0.116505,0.048544,0.009709
2698,414,415,1,ROT,1585,1,3,2530,2,446.961489,0.028986,0.024155,0.004831
2699,415,416,1,ROT,1584,1,19,2531,2,446.990475,0.028916,0.024096,0.004819
2700,416,415,1,ROT,1585,0,15,2544,2,447.019390,0.024038,0.024038,0.004819
2701,415,417,2,SCHWARZ,1583,1,17,2122,2,447.043429,0.115663,0.048193,0.009639
2702,417,416,1,SCHWARZ,1584,0,3,2693,2,447.159092,0.023981,0.023981,0.009639
2703,416,414,2,ROT,1586,0,24,2546,2,447.183072,0.096154,0.048077,0.009639
2704,414,418,4,SCHWARZ,1582,1,35,2126,2,447.279226,0.463768,0.096618,0.019324
2705,418,417,1,SCHWARZ,1583,0,27,2694,2,447.742994,0.023923,0.023923,0.019324
2706,417,415,2,ROT,1585,0,31,2548,2,447.766918,0.095923,0.047962,0.019324
2707,415,411,4,SCHWARZ,1589,0,0,2698,2,447.862841,0.385542,0.096386,0.019324
2708,411,403,8,ROT,1597,0,13,2556,2,448.248383,1.557178,0.194647,0.019324
2709,403,387,16,SCHWARZ,1613,0,3,2714,2,449.805561,6.352357,0.397022,0.019324
2710,387,419,32,ROT,1581,1,34,2563,2,456.157918,31.751938,0.826873,0.165375
2711,419,420,1,ROT,1580,1,16,2564,2,487.909856,0.028640,0.023866,0.004773
2712,420,421,1,ROT,1579,1,21,2565,2,487.938496,0.028571,0.023810,0.004762
2713,421,422,1,ROT,1578,1,18,2566,2,487.967067,0.028504,0.023753,0.004751
2714,422,421,1,ROT,1579,0,24,2557,2,487.995571,0.023697,0.023697,0.004751
2715,421,423,2,SCHWARZ,1577,1,13,2128,2,488.019267,0.114014,0.047506,0.009501
2716,423,424,1,SCHWARZ,1576,1,6,2129,2,488.133282,0.028369,0.023641,0.004728
2717,424,423,1,SCHWARZ,1577,0,32,2715,2,488.161651,0.023585,0.023585,0.004728
2718,423,421,2,ROT,1579,0,6,2559,2,488.185235,0.094563,0.047281,0.004728
2719,421,417,4,SCHWARZ,1583,0,12,2719,2,488.279798,0.380048,0.095012,0.004728
2720,417,409,8,ROT,1591,0,29,2567,2,488.659846,1.534772,0.191847,0.004728
2721,409,393,16,SCHWARZ,1607,0,32,2735,2,490.194618,6.259169,0.391198,0.004728
2722,393,361,32,ROT,1639,0,33,2599,2,496.453786,26.055980,0.814249,0.004728
2723,361,297,64,SCHWARZ,1703,0,27,2799,2,522.509766,113.462604,1.772853,0.004728
2724,297,298,1,ROT,1702,1,32,2567,2,635.972370,0.040404,0.033670,0.006734
2725,298,297,1,ROT,1703,0,24,2600,2,636.012774,0.033557,0.033557,0.006734
2726,297,295,2,SCHWARZ,1705,0,27,2801,2,636.046331,0.134680,0.067340,0.006734
2727,295,291,4,ROT,1709,0,8,2604,2,636.181011,0.542373,0.135593,0.006734
2728,291,299,8,SCHWARZ,1701,1,2,2137,2,636.723384,2.639175,0.274914,0.054983
2729,299,300,1,SCHWARZ,1700,1,8,2138,2,639.362559,0.040134,0.033445,0.006689
2730,300,299,1,SCHWARZ,1701,0,7,2802,2,639.402693,0.033333,0.033333,0.006689
2731,299,297,2,ROT,1703,0,13,2606,2,639.436026,0.133779,0.066890,0.006689
2732,297,293,4,SCHWARZ,1707,0,1,2806,2,639.569806,0.538721,0.134680,0.006689
2733,293,301,8,ROT,1699,1,12,2575,2,640.108526,2.621160,0.273038,0.054608
2734,301,302,1,ROT,1698,1,36,2576,2,642.729687,0.039867,0.033223,0.006645
2735,302,303,1,ROT,1697,1,36,2577,2,642.769554,0.039735,0.033113,0.006623
2736,303,302,1,ROT,1698,0,11,2607,2,642.809289,0.033003,0.033003,0.006623
2737,302,300,2,SCHWARZ,1700,0,30,2808,2,642.842292,0.132450,0.066225,0.006623
2738,300,304,4,ROT,1696,1,32,2581,2,642.974743,0.640000,0.133333,0.026667
2739,304,305,1,ROT,1695,1,14,2582,2,643.614743,0.039474,0.032895,0.006579
2740,305,304,1,ROT,1696,0,8,2608,2,643.654216,0.032787,0.032787,0.006579
2741,304,302,2,SCHWARZ,1698,0,14,2810,2,643.687003,0.131579,0.065789,0.006579
2742,302,298,4,ROT,1702,0,13,2612,2,643.818582,0.529801,0.132450,0.006579
2743,298,306,8,SCHWARZ,1694,1,17,2146,2,644.348383,2.577181,0.268456,0.053691
2744,306,305,1,SCHWARZ,1695,0,19,2811,2,646.925565,0.032680,0.032680,0.053691
2745,305,303,2,ROT,1697,0,33,2614,2,646.958244,0.131148,0.065574,0.053691
2746,303,307,4,SCHWARZ,1693,1,33,2150,2,647.089392,0.633663,0.132013,0.026403
2747,307,308,1,SCHWARZ,1692,1,13,2151,2,647.723055,0.039088,0.032573,0.006515
2748,308,307,1,SCHWARZ,1693,0,0,2812,2,647.762143,0.032468,0.032468,0.006515
2749,307,305,2,ROT,1695,0,17,2616,2,647.794611,0.130293,0.065147,0.006515
2750,305,301,4,SCHWARZ,1699,0,9,2816,2,647.924904,0.524590,0.131148,0.006515
2751,301,293,8,ROT,1707,0,8,2624,2,648.449494,2.126246,0.265781,0.006515
2752,293,309,16,SCHWARZ,1691,1,20,2167,2,650.575740,10.484642,0.546075,0.109215
2753,309,310,1,SCHWARZ,1690,1,10,2168,2,661.060382,0.038835,0.032362,0.006472
2754,310,311,1,SCHWARZ,1689,1,13,2169,2,661.099217,0.038710,0.032258,0.006452
2755,311,312,1,SCHWARZ,1688,1,20,2170,2,661.137926,0.038585,0.032154,0.006431
2756,312,311,1,SCHWARZ,1689,0,34,2817,2,661.176511,0.032051,0.032051,0.006431
2757,311,313,2,ROT,1687,1,18,2584,2,661.208563,0.154341,0.064309,0.012862
2758,313,314,1,ROT,1686,1,7,2585,2,661.362904,0.038339,0.031949,0.006390
2759,314,313,1,ROT,1687,0,4,2625,2,661.401242,0.031847,0.031847,0.006390
2760,313,315,2,SCHWARZ,1685,1,11,2172,2,661.433089,0.153355,0.063898,0.012780
2761,315,316,1,SCHWARZ,1684,1,20,2173,2,661.586444,0.038095,0.031746,0.006349
2762,316,317,1,SCHWARZ,1683,1,2,2174,2,661.624539,0.037975,0.031646,0.006329
2763,317,316,1,SCHWARZ,1684,0,3,2818,2,661.662514,0.031546,0.031546,0.006329
2764,316,318,2,ROT,1682,1,16,2587,2,661.694060,0.151899,0.063291,0.012658
2765,318,317,1,ROT,1683,0,29,2626,2,661.845958,0.031447,0.031447,0.012658
2766,317,315,2,SCHWARZ,1685,0,27,2820,2,661.877405,0.126183,0.063091,0.012658
2767,315,319,4,ROT,1681,1,9,2591,2,662.003588,0.609524,0.126984,0.025397
2768,319,318,1,ROT,1682,0,8,2627,2,662.613112,0.031348,0.031348,0.025397
2769,318,316,2,SCHWARZ,1684,0,36,2822,2,662.644460,0.125786,0.062893,0.025397
2770,316,320,4,ROT,1680,1,34,2595,2,662.770246,0.607595,0.126582,0.025316
2771,320,321,1,ROT,1679,1,23,2596,2,663.377841,0.037500,0.031250,0.006250
2772,321,320,1,ROT,1680,0,22,2628,2,663.415341,0.031153,0.031153,0.006250
2773,320,318,2,SCHWARZ,1682,0,36,2824,2,663.446493,0.125000,0.062500,0.006250
2774,318,322,4,ROT,1678,1,23,2600,2,663.571493,0.603774,0.125786,0.025157
2775,322,321,1,ROT,1679,0,6,2629,2,664.175267,0.031056,0.031056,0.025157
2776,321,319,2,SCHWARZ,1681,0,16,2826,2,664.206323,0.124611,0.062305,0.025157
2777,319,323,4,ROT,1677,1,12,2604,2,664.330933,0.601881,0.125392,0.025078
2778,323,322,1,ROT,1678,0,31,2630,2,664.932814,0.030960,0.030960,0.025078
2779,322,320,2,SCHWARZ,1680,0,32,2828,2,664.963774,0.124224,0.062112,0.025078
2780,320,324,4,ROT,1676,1,36,2608,2,665.087998,0.600000,0.125000,0.025000
2781,324,323,1,ROT,1677,0,26,2631,2,665.687998,0.030864,0.030864,0.025000
2782,323,321,2,SCHWARZ,1679,0,7,2830,2,665.718862,0.123839,0.061920,0.025000
2783,321,317,4,ROT,1683,0,4,2635,2,665.842701,0.498442,0.124611,0.025000
2784,317,309,8,SCHWARZ,1691,0,7,2838,2,666.341143,2.018927,0.252366,0.025000
2785,309,293,16,ROT,1707,0,24,2651,2,668.360071,8.284790,0.517799,0.025000
2786,293,261,32,SCHWARZ,1739,0,36,2870,2,676.644860,34.948805,1.092150,0.025000
2787,261,325,64,ROT,1675,1,25,2672,2,711.593666,188.321840,2.452107,0.490421
2788,325,326,1,ROT,1674,1,14,2673,2,899.915505,0.036923,0.030769,0.006154
2789,326,327,1,ROT,1673,1,1,2674,2,899.952428,0.036810,0.030675,0.006135
2790,327,328,1,ROT,1672,1,16,2675,2,899.989238,0.036697,0.030581,0.006116
2791,328,329,1,ROT,1671,1,5,2676,2,900.025935,0.036585,0.030488,0.006098
2792,329,330,1,ROT,1670,1,34,2677,2,900.062521,0.036474,0.030395,0.006079
2793,330,329,1,ROT,1671,0,2,2652,2,900.098995,0.030303,0.030303,0.006079
2794,329,331,2,SCHWARZ,1669,1,26,2176,2,900.129298,0.145897,0.060790,0.012158
2795,331,330,1,SCHWARZ,1670,0,27,2871,2,900.275195,0.030211,0.030211,0.012158
2796,330,332,2,ROT,1668,1,32,2679,2,900.305406,0.145455,0.060606,0.012121
2797,332,333,1,ROT,1667,1,3,2680,2,900.450861,0.036145,0.030120,0.006024
2798,333,334,1,ROT,1666,1,9,2681,2,900.487005,0.036036,0.030030,0.006006
2799,334,335,1,ROT,1665,1,3,2682,2,900.523041,0.035928,0.029940,0.005988
2800,335,334,1,ROT,1666,0,10,2653,2,900.558969,0.029851,0.029851,0.005988
2801,334,332,2,SCHWARZ,1668,0,3,2873,2,900.588820,0.119760,0.059880,0.005988
2802,332,328,4,ROT,1672,0,4,2657,2,900.708581,0.481928,0.120482,0.005988
2803,328,320,8,SCHWARZ,1680,0,1,2881,2,901.190508,1.951220,0.243902,0.005988
2804,320,304,16,ROT,1696,0,31,2673,2,903.141728,8.000000,0.500000,0.005988
2805,304,272,32,SCHWARZ,1728,0,27,2913,2,911.141728,33.684211,1.052632,0.005988
2806,272,336,64,ROT,1664,1,25,2746,2,944.825938,180.705883,2.352941,0.470588
2807,336,335,1,ROT,1665,0,24,2674,3,125.531821,0.029762,0.029762,0.470588
2808,335,333,2,SCHWARZ,1667,0,32,2915,3,125.561583,0.119403,0.059701,0.470588
2809,333,329,4,ROT,1671,0,28,2678,3,125.680986,0.480480,0.120120,0.470588
2810,329,321,8,SCHWARZ,1679,0,30,2923,3,126.161467,1.945289,0.243161,0.470588
2811,321,337,16,ROT,1663,1,30,2762,3,128.106755,9.570093,0.498442,0.099688
2812,337,336,1,ROT,1664,0,33,2679,3,137.676849,0.029674,0.029674,0.099688
2813,336,334,2,SCHWARZ,1666,0,27,2925,3,137.706522,0.119048,0.059524,0.099688
2814,334,330,4,ROT,1670,0,6,2683,3,137.825570,0.479042,0.119760,0.099688
2815,330,322,8,SCHWARZ,1678,0,9,2933,3,138.304612,1.939394,0.242424,0.099688
2816,322,338,16,ROT,1662,1,16,2778,3,140.244006,9.540373,0.496894,0.099379
2817,338,337,1,ROT,1663,0,33,2684,3,149.784379,0.029586,0.029586,0.099379
2818,337,339,2,SCHWARZ,1661,1,11,2178,3,149.813964,0.142433,0.059347,0.011869
2819,339,338,1,SCHWARZ,1662,0,27,2934,3,149.956398,0.029499,0.029499,0.011869
2820,338,340,2,ROT,1660,1,27,2780,3,149.985896,0.142012,0.059172,0.011834
2821,340,341,1,ROT,1659,1,18,2781,3,150.127908,0.035294,0.029412,0.005882
2822,341,342,1,ROT,1658,1,34,2782,3,150.163202,0.035191,0.029326,0.005865
2823,342,341,1,ROT,1659,0,15,2685,3,150.198393,0.029240,0.029240,0.005865
2824,341,343,2,SCHWARZ,1657,1,22,2180,3,150.227633,0.140762,0.058651,0.011730
2825,343,344,1,SCHWARZ,1656,1,15,2181,3,150.368395,0.034985,0.029155,0.005831
2826,344,343,1,SCHWARZ,1657,0,18,2935,3,150.403380,0.029070,0.029070,0.005831
2827,343,341,2,ROT,1659,0,17,2687,3,150.432450,0.116618,0.058309,0.005831
2828,341,337,4,SCHWARZ,1663,0,7,2939,3,150.549068,0.469208,0.117302,0.005831
2829,337,329,8,ROT,1671,0,10,2695,3,151.018276,1.899110,0.237389,0.005831
2830,329,313,16,SCHWARZ,1687,0,7,2955,3,152.917386,7.781155,0.486322,0.005831
2831,313,281,32,ROT,1719,0,17,2727,3,160.698541,32.715655,1.022364,0.005831
2832,281,217,64,SCHWARZ,1783,0,25,3019,3,193.414196,145.765125,2.277580,0.005831
2833,217,216,1,ROT,1784,0,4,2728,3,339.179321,0.046083,0.046083,0.005831
2834,216,218,2,SCHWARZ,1782,1,20,2183,3,339.225404,0.222222,0.092593,0.018519
2835,218,217,1,SCHWARZ,1783,0,32,3020,3,339.447626,0.045872,0.045872,0.018519
2836,217,219,2,ROT,1781,1,30,2784,3,339.493498,0.221198,0.092166,0.018433
2837,219,218,1,ROT,1782,0,28,2729,3,339.714696,0.045662,0.045662,0.018433
2838,218,220,2,SCHWARZ,1780,1,29,2185,3,339.760358,0.220183,0.091743,0.018349
2839,220,221,1,SCHWARZ,1779,1,29,2186,3,339.980541,0.054545,0.045455,0.009091
2840,221,220,1,SCHWARZ,1780,0,0,3021,3,340.035087,0.045249,0.045249,0.009091
2841,220,218,2,ROT,1782,0,2,2731,3,340.080336,0.181818,0.090909,0.009091
2842,218,222,4,SCHWARZ,1778,1,31,2190,3,340.262154,0.880734,0.183486,0.036697
2843,222,223,1,SCHWARZ,1777,1,20,2191,3,341.142888,0.054054,0.045045,0.009009
2844,223,224,1,SCHWARZ,1776,1,11,2192,3,341.196942,0.053812,0.044843,0.008969
2845,224,225,1,SCHWARZ,1775,1,28,2193,3,341.250753,0.053571,0.044643,0.008929
2846,225,224,1,SCHWARZ,1776,0,5,3022,3,341.304325,0.044444,0.044444,0.008929
2847,224,226,2,ROT,1774,1,3,2786,3,341.348769,0.214286,0.089286,0.017857
2848,226,225,1,ROT,1775,0,8,2732,3,341.563055,0.044248,0.044248,0.017857
2849,225,223,2,SCHWARZ,1777,0,18,3024,3,341.607303,0.177778,0.088889,0.017857
2850,223,227,4,ROT,1773,1,14,2790,3,341.785081,0.860987,0.179372,0.035874
2851,227,228,1,ROT,1772,1,34,2791,3,342.646067,0.052863,0.044053,0.008811
2852,228,227,1,ROT,1773,0,35,2733,3,342.698931,0.043860,0.043860,0.008811
2853,227,225,2,SCHWARZ,1775,0,30,3026,3,342.742790,0.176211,0.088106,0.008811
2854,225,229,4,ROT,1771,1,3,2795,3,342.919002,0.853333,0.177778,0.035556
2855,229,230,1,ROT,1770,1,14,2796,3,343.772335,0.052402,0.043668,0.008734
2856,230,229,1,ROT,1771,0,2,2734,3,343.824737,0.043478,0.043478,0.008734
2857,229,231,2,SCHWARZ,1769,1,29,2195,3,343.868215,0.209607,0.087336,0.017467
2858,231,232,1,SCHWARZ,1768,1,6,2196,3,344.077822,0.051948,0.043290,0.008658
2859,232,231,1,SCHWARZ,1769,0,27,3027,3,344.129770,0.043103,0.043103,0.008658
2860,231,229,2,ROT,1771,0,31,2736,3,344.172874,0.173160,0.086580,0.008658
2861,229,225,4,SCHWARZ,1775,0,18,3031,3,344.346034,0.698690,0.174672,0.008658
2862,225,217,8,ROT,1783,0,0,2744,3,345.044724,2.844444,0.355556,0.008658
2863,217,201,16,SCHWARZ,1799,0,36,3047,3,347.889168,11.797235,0.737327,0.008658
2864,201,169,32,ROT,1831,0,24,2776,3,359.686403,50.945274,1.592040,0.008658
2865,169,105,64,SCHWARZ,1895,0,30,3111,3,410.631677,242.366864,3.786982,0.008658
2866,105,106,1,ROT,1894,1,30,2797,3,652.998541,0.114286,0.095238,0.019048
2867,106,107,1,ROT,1893,1,1,2798,3,653.112826,0.113208,0.094340,0.018868
2868,107,108,1,ROT,1892,1,19,2799,3,653.226034,0.112150,0.093458,0.018692
2869,108,109,1,ROT,1891,1,32,2800,3,653.338183,0.111111,0.092593,0.018519
2870,109,108,1,ROT,1892,0,10,2777,3,653.449295,0.091743,0.091743,0.018519
2871,108,106,2,SCHWARZ,1894,0,27,3113,3,653.541038,0.370370,0.185185,0.018519
2872,106,110,4,ROT,1890,1,1,2804,3,653.911408,1.811321,0.377358,0.075472
2873,110,109,1,ROT,1891,0,10,2778,3,655.722729,0.090909,0.090909,0.075472
2874,109,111,2,SCHWARZ,1889,1,11,2198,3,655.813638,0.440367,0.183486,0.036697
2875,111,112,1,SCHWARZ,1888,1,11,2199,3,656.254005,0.108108,0.090090,0.018018
2876,112,111,1,SCHWARZ,1889,0,27,3114,3,656.362113,0.089286,0.089286,0.018018
2877,111,113,2,ROT,1887,1,1,2806,3,656.451399,0.432432,0.180180,0.036036
2878,113,114,1,ROT,1886,1,34,2807,3,656.883831,0.106195,0.088496,0.017699
2879,114,113,1,ROT,1887,0,10,2779,3,656.990026,0.087719,0.087719,0.017699
2880,113,111,2,SCHWARZ,1889,0,0,3116,3,657.077745,0.353982,0.176991,0.017699
2881,111,115,4,ROT,1885,1,23,2811,3,657.431727,1.729730,0.360360,0.072072
2882,115,116,1,ROT,1884,1,9,2812,3,659.161457,0.104348,0.086957,0.017391
2883,116,117,1,ROT,1883,1,27,2813,3,659.265805,0.103448,0.086207,0.017241
2884,117,118,1,ROT,1882,1,21,2814,3,659.369253,0.102564,0.085470,0.017094
2885,118,119,1,ROT,1881,1,1,2815,3,659.471817,0.101695,0.084746,0.016949
2886,119,118,1,ROT,1882,0,17,2780,3,659.573512,0.084034,0.084034,0.016949
2887,118,116,2,SCHWARZ,1884,0,18,3118,3,659.657546,0.338983,0.169492,0.016949
2888,116,112,4,ROT,1888,0,13,2784,3,659.996529,1.379310,0.344828,0.016949
2889,112,120,8,SCHWARZ,1880,1,10,2207,3,661.375839,6.857143,0.714286,0.142857
2890,120,119,1,SCHWARZ,1881,0,34,3119,3,668.232982,0.083333,0.083333,0.142857
2891,119,117,2,ROT,1883,0,24,2786,3,668.316315,0.336134,0.168067,0.142857
2892,117,113,4,SCHWARZ,1887,0,32,3123,3,668.652450,1.367521,0.341880,0.142857
2893,113,105,8,ROT,1895,0,13,2794,3,670.019971,5.663717,0.707965,0.142857
2894,105,89,16,SCHWARZ,1911,0,7,3139,3,675.683688,24.380952,1.523810,0.142857
2895,89,121,32,ROT,1879,1,19,2847,3,700.064640,138.067416,3.595506,0.719101
2896,121,120,1,ROT,1880,0,29,2795,3,838.132057,0.082645,0.082645,0.719101
2897,120,122,2,SCHWARZ,1878,1,31,2209,3,838.214701,0.400000,0.166667,0.033333
2898,122,121,1,SCHWARZ,1879,0,25,3140,3,838.614701,0.081967,0.081967,0.033333
2899,121,119,2,ROT,1881,0,15,2797,3,838.696668,0.330579,0.165289,0.033333
2900,119,115,4,SCHWARZ,1885,0,36,3144,3,839.027247,1.344538,0.336134,0.033333
2901,115,123,8,ROT,1877,1,34,2855,3,840.371785,6.678261,0.695652,0.139130
2902,123,122,1,ROT,1878,0,0,2798,3,847.050046,0.081301,0.081301,0.139130
2903,122,124,2,SCHWARZ,1876,1,31,2211,3,847.131346,0.393443,0.163934,0.032787
2904,124,123,1,SCHWARZ,1877,0,34,3145,3,847.524789,0.080645,0.080645,0.032787
2905,123,125,2,ROT,1875,1,9,2857,3,847.605434,0.390244,0.162602,0.032520
2906,125,126,1,ROT,1874,1,36,2858,3,847.995678,0.096000,0.080000,0.016000
2907,126,125,1,ROT,1875,0,24,2799,3,848.091678,0.079365,0.079365,0.016000
2908,125,123,2,SCHWARZ,1877,0,9,3147,3,848.171043,0.320000,0.160000,0.016000
2909,123,127,4,ROT,1873,1,9,2862,3,848.491043,1.560976,0.325203,0.065041
2910,127,126,1,ROT,1874,0,24,2800,3,850.052019,0.078740,0.078740,0.065041
2911,126,128,2,SCHWARZ,1872,1,20,2213,3,850.130759,0.380952,0.158730,0.031746
2912,128,127,1,SCHWARZ,1873,0,19,3148,3,850.511711,0.078125,0.078125,0.031746
2913,127,129,2,ROT,1871,1,12,2864,3,850.589836,0.377953,0.157480,0.031496
2914,129,130,1,ROT,1870,1,9,2865,3,850.967789,0.093023,0.077519,0.015504
2915,130,129,1,ROT,1871,0,10,2801,3,851.060812,0.076923,0.076923,0.015504
2916,129,127,2,SCHWARZ,1873,0,36,3150,3,851.137735,0.310078,0.155039,0.015504
2917,127,131,4,ROT,1869,1,9,2869,3,851.447813,1.511811,0.314961,0.062992
2918,131,132,1,ROT,1868,1,3,2870,3,852.959624,0.091603,0.076336,0.015267
2919,132,131,1,ROT,1869,0,0,2802,3,853.051227,0.075758,0.075758,0.015267
2920,131,129,2,SCHWARZ,1871,0,32,3152,3,853.126985,0.305344,0.152672,0.015267
2921,129,125,4,ROT,1875,0,13,2806,3,853.432328,1.240310,0.310078,0.015267
2922,125,133,8,SCHWARZ,1867,1,22,2221,3,854.672638,6.144000,0.640000,0.128000
2923,133,134,1,SCHWARZ,1866,1,11,2222,3,860.816638,0.090226,0.075188,0.015038
2924,134,135,1,SCHWARZ,1865,1,6,2223,3,860.906864,0.089552,0.074627,0.014925
2925,135,134,1,SCHWARZ,1866,0,27,3153,3,860.996416,0.074074,0.074074,0.014925
2926,134,132,2,ROT,1868,0,31,2808,3,861.070490,0.298507,0.149254,0.014925
2927,132,128,4,SCHWARZ,1872,0,30,3157,3,861.368998,1.212121,0.303030,0.014925
2928,128,120,8,ROT,1880,0,28,2816,3,862.581119,5.000000,0.625000,0.014925
2929,120,104,16,SCHWARZ,1896,0,27,3173,3,867.581119,21.333333,1.333333,0.014925
2930,104,136,32,ROT,1864,1,3,2902,3,888.914452,118.153846,3.076923,0.615385
2931,136,135,1,ROT,1865,0,35,2817,4,7.068299,0.073529,0.073529,0.615385
2932,135,133,2,SCHWARZ,1867,0,23,3175,4,7.141828,0.296296,0.148148,0.615385
2933,133,129,4,ROT,1871,0,11,2821,4,7.438124,1.203008,0.300752,0.615385
2934,129,121,8,SCHWARZ,1879,0,34,3183,4,8.641132,4.961240,0.620155,0.615385
2935,121,105,16,ROT,1895,0,4,2837,4,13.602372,21.157025,1.322314,0.615385
2936,105,73,32,SCHWARZ,1927,0,14,3215,4,34.759397,97.523810,3.047619,0.615385
2937,73,137,64,ROT,1863,1,23,2966,4,132.283206,673.315070,8.767123,1.753425
2938,137,136,1,ROT,1864,0,8,2838,4,805.598277,0.072993,0.072993,1.753425
2939,136,138,2,SCHWARZ,1862,1,6,2225,4,805.671269,0.352941,0.147059,0.029412
2940,138,137,1,SCHWARZ,1863,0,27,3216,4,806.024210,0.072464,0.072464,0.029412
2941,137,135,2,ROT,1865,0,2,2840,4,806.096674,0.291971,0.145985,0.029412
2942,135,139,4,SCHWARZ,1861,1,11,2229,4,806.388645,1.422222,0.296296,0.059259
2943,139,140,1,SCHWARZ,1860,1,26,2230,4,807.810867,0.086331,0.071942,0.014388
2944,140,139,1,SCHWARZ,1861,0,14,3217,4,807.897198,0.071429,0.071429,0.014388
2945,139,141,2,ROT,1859,1,21,2968,4,807.968627,0.345324,0.143885,0.028777
2946,141,140,1,ROT,1860,0,11,2841,4,808.313950,0.070922,0.070922,0.028777
2947,140,138,2,SCHWARZ,1862,0,32,3219,4,808.384872,0.285714,0.142857,0.028777
2948,138,134,4,ROT,1866,0,35,2845,4,808.670587,1.159420,0.289855,0.028777
2949,134,126,8,SCHWARZ,1874,0,21,3227,4,809.830007,4.776119,0.597015,0.028777
2950,126,142,16,ROT,1858,1,34,2984,4,814.606126,24.380952,1.269841,0.253968
2951,142,141,1,ROT,1859,0,35,2846,4,838.987079,0.070423,0.070423,0.253968
2952,141,143,2,SCHWARZ,1857,1,4,2232,4,839.057501,0.340426,0.141844,0.028369
2953,143,144,1,SCHWARZ,1856,1,28,2233,4,839.397927,0.083916,0.069930,0.013986
2954,144,145,1,SCHWARZ,1855,1,6,2234,4,839.481843,0.083333,0.069444,0.013889
2955,145,144,1,SCHWARZ,1856,0,23,3228,4,839.565176,0.068966,0.068966,0.013889
2956,144,142,2,ROT,1858,0,11,2848,4,839.634142,0.277778,0.138889,0.013889
2957,142,146,4,SCHWARZ,1854,1,17,2238,4,839.911920,1.352113,0.281690,0.056338
2958,146,147,1,SCHWARZ,1853,1,15,2239,4,841.264032,0.082192,0.068493,0.013699
2959,147,146,1,SCHWARZ,1854,0,36,3229,4,841.346224,0.068027,0.068027,0.013699
2960,146,148,2,ROT,1852,1,36,2986,4,841.414251,0.328767,0.136986,0.027397
2961,148,149,1,ROT,1851,1,9,2987,4,841.743018,0.081081,0.067568,0.013514
2962,149,150,1,ROT,1850,1,23,2988,4,841.824100,0.080537,0.067114,0.013423
2963,150,149,1,ROT,1851,0,13,2849,4,841.904636,0.066667,0.066667,0.013423
2964,149,147,2,SCHWARZ,1853,0,12,3231,4,841.971303,0.268456,0.134228,0.013423
2965,147,143,4,ROT,1857,0,31,2853,4,842.239760,1.088435,0.272109,0.013423
2966,143,135,8,SCHWARZ,1865,0,18,3239,4,843.328195,4.475524,0.559441,0.013423
2967,135,119,16,ROT,1881,0,26,2869,4,847.803719,18.962963,1.185185,0.013423
2968,119,87,32,SCHWARZ,1913,0,19,3271,4,866.766682,86.050420,2.689076,0.013423
2969,87,151,64,ROT,1849,1,19,3052,4,952.817102,564.965519,7.356322,1.471264
2970,151,150,1,ROT,1850,0,35,2870,5,517.782621,0.066225,0.066225,1.471264
2971,150,148,2,SCHWARZ,1852,0,14,3273,5,517.848846,0.266667,0.133333,1.471264
2972,148,144,4,ROT,1856,0,33,2874,5,518.115513,1.081081,0.270270,1.471264
2973,144,136,8,SCHWARZ,1864,0,0,3281,5,519.196594,4.444444,0.555556,1.471264
2974,136,120,16,ROT,1880,0,20,2890,5,523.641039,18.823529,1.176471,1.471264
2975,120,88,32,SCHWARZ,1912,0,21,3313,5,542.464568,85.333333,2.666667,1.471264
2976,88,152,64,ROT,1848,1,5,3116,5,627.797901,558.545456,7.272727,1.454545
2977,152,153,1,ROT,1847,1,3,3117,6,186.343357,0.078947,0.065789,0.013158
2978,153,154,1,ROT,1846,1,32,3118,6,186.422305,0.078431,0.065359,0.013072
2979,154,153,1,ROT,1847,0,33,2891,6,186.500736,0.064935,0.064935,0.013072
2980,153,151,2,SCHWARZ,1849,0,0,3315,6,186.565671,0.261438,0.130719,0.013072
2981,151,155,4,ROT,1845,1,7,3122,6,186.827109,1.271523,0.264901,0.052980
2982,155,156,1,ROT,1844,1,1,3123,6,188.098632,0.077419,0.064516,0.012903
2983,156,155,1,ROT,1845,0,29,2892,6,188.176051,0.064103,0.064103,0.012903
2984,155,157,2,SCHWARZ,1843,1,6,2241,6,188.240154,0.309677,0.129032,0.025806
2985,157,158,1,SCHWARZ,1842,1,2,2242,6,188.549831,0.076433,0.063694,0.012739
2986,158,157,1,SCHWARZ,1843,0,30,3316,6,188.626265,0.063291,0.063291,0.012739
2987,157,159,2,ROT,1841,1,19,3125,6,188.689556,0.305732,0.127389,0.025478
2988,159,158,1,ROT,1842,0,24,2893,6,188.995288,0.062893,0.062893,0.025478
2989,158,160,2,SCHWARZ,1840,1,29,2244,6,189.058181,0.303797,0.126582,0.025316
2990,160,159,1,SCHWARZ,1841,0,25,3317,6,189.361979,0.062500,0.062500,0.025316
2991,159,157,2,ROT,1843,0,31,2895,6,189.424479,0.251572,0.125786,0.025316
2992,157,161,4,SCHWARZ,1839,1,8,2248,6,189.676051,1.222930,0.254777,0.050955
2993,161,160,1,SCHWARZ,1840,0,36,3318,6,190.898981,0.062112,0.062112,0.050955
2994,160,162,2,ROT,1838,1,5,3127,6,190.961093,0.300000,0.125000,0.025000
2995,162,163,1,ROT,1837,1,16,3128,6,191.261093,0.074074,0.061728,0.012346
2996,163,164,1,ROT,1836,1,19,3129,6,191.335167,0.073620,0.061350,0.012270
2997,164,165,1,ROT,1835,1,14,3130,6,191.408786,0.073171,0.060976,0.012195
2998,165,164,1,ROT,1836,0,28,2896,6,191.481957,0.060606,0.060606,0.012195
2999,164,166,2,SCHWARZ,1834,1,33,2250,6,191.542563,0.292683,0.121951,0.024390
3000,166,165,1,SCHWARZ,1835,0,32,3319,6,191.835246,0.060241,0.060241,0.024390
3001,165,167,2,ROT,1833,1,27,3132,6,191.895487,0.290909,0.121212,0.024242
3002,167,166,1,ROT,1834,0,17,2897,6,192.186396,0.059880,0.059880,0.024242
3003,166,168,2,SCHWARZ,1832,1,4,2252,6,192.246277,0.289157,0.120482,0.024096
3004,168,167,1,SCHWARZ,1833,0,9,3320,6,192.535433,0.059524,0.059524,0.024096
3005,167,165,2,ROT,1835,0,20,2899,6,192.594957,0.239521,0.119760,0.024096
3006,165,161,4,SCHWARZ,1839,0,3,3324,6,192.834478,0.969697,0.242424,0.024096
3007,161,169,8,ROT,1831,1,21,3140,6,193.804175,4.770186,0.496894,0.099379
3008,169,170,1,ROT,1830,1,36,3141,6,198.574361,0.071006,0.059172,0.011834
3009,170,169,1,ROT,1831,0,26,2900,6,198.645367,0.058824,0.058824,0.011834
3010,169,167,2,SCHWARZ,1833,0,3,3326,6,198.704191,0.236686,0.118343,0.011834
3011,167,163,4,ROT,1837,0,20,2904,6,198.940877,0.958084,0.239521,0.011834
3012,163,171,8,SCHWARZ,1829,1,28,2260,6,199.898961,4.711656,0.490798,0.098160
3013,171,172,1,SCHWARZ,1828,1,29,2261,6,204.610617,0.070175,0.058480,0.011696
3014,172,173,1,SCHWARZ,1827,1,11,2262,6,204.680793,0.069767,0.058140,0.011628
3015,173,174,1,SCHWARZ,1826,1,26,2263,6,204.750560,0.069364,0.057803,0.011561
3016,174,175,1,SCHWARZ,1825,1,22,2264,6,204.819924,0.068966,0.057471,0.011494
3017,175,174,1,SCHWARZ,1826,0,5,3327,6,204.888890,0.057143,0.057143,0.011494
3018,174,172,2,ROT,1828,0,17,2906,6,204.946033,0.229885,0.114943,0.011494
3019,172,176,4,SCHWARZ,1824,1,8,2268,6,205.175918,1.116279,0.232558,0.046512
3020,176,177,1,SCHWARZ,1823,1,6,2269,6,206.292197,0.068182,0.056818,0.011364
3021,177,176,1,SCHWARZ,1824,0,3,3328,6,206.360379,0.056497,0.056497,0.011364
3022,176,174,2,ROT,1826,0,24,2908,6,206.416876,0.227273,0.113636,0.011364
3023,174,170,4,SCHWARZ,1830,0,23,3332,6,206.644149,0.919540,0.229885,0.011364
3024,170,162,8,ROT,1838,0,10,2916,6,207.563689,3.764706,0.470588,0.011364
3025,162,178,16,SCHWARZ,1822,1,29,2285,6,211.328395,18.962963,0.987654,0.197531
3026,178,177,1,SCHWARZ,1823,0,14,3333,6,230.291358,0.056180,0.056180,0.197531
3027,177,179,2,ROT,1821,1,7,3143,6,230.347538,0.271186,0.112994,0.022599
3028,179,180,1,ROT,1820,1,19,3144,6,230.618724,0.067039,0.055866,0.011173
3029,180,179,1,ROT,1821,0,17,2917,6,230.685763,0.055556,0.055556,0.011173
3030,179,177,2,SCHWARZ,1823,0,1,3335,6,230.741319,0.223464,0.111732,0.011173
3031,177,181,4,ROT,1819,1,36,3148,6,230.964782,1.084746,0.225989,0.045198
3032,181,180,1,ROT,1820,0,22,2918,6,232.049528,0.055249,0.055249,0.045198
3033,180,178,2,SCHWARZ,1822,0,19,3337,6,232.104777,0.222222,0.111111,0.045198
3034,178,174,4,ROT,1826,0,22,2922,6,232.326999,0.898876,0.224719,0.045198
3035,174,182,8,SCHWARZ,1818,1,8,2293,6,233.225875,4.413793,0.459770,0.091954
3036,182,183,1,SCHWARZ,1817,1,31,2294,6,237.639668,0.065934,0.054945,0.010989
3037,183,182,1,SCHWARZ,1818,0,21,3338,6,237.705602,0.054645,0.054645,0.010989
3038,182,184,2,ROT,1816,1,34,3150,6,237.760247,0.263736,0.109890,0.021978
3039,184,183,1,ROT,1817,0,6,2923,6,238.023984,0.054348,0.054348,0.021978
3040,183,185,2,SCHWARZ,1815,1,24,2296,6,238.078331,0.262295,0.109290,0.021858
3041,185,186,1,SCHWARZ,1814,1,24,2297,6,238.340626,0.064865,0.054054,0.010811
3042,186,187,1,SCHWARZ,1813,1,22,2298,6,238.405491,0.064516,0.053763,0.010753
3043,187,188,1,SCHWARZ,1812,1,13,2299,6,238.470007,0.064171,0.053476,0.010695
3044,188,189,1,SCHWARZ,1811,1,2,2300,6,238.534179,0.063830,0.053191,0.010638
3045,189,188,1,SCHWARZ,1812,0,23,3339,6,238.598008,0.052910,0.052910,0.010638
3046,188,190,2,ROT,1810,1,1,3152,6,238.650918,0.255319,0.106383,0.021277
3047,190,191,1,ROT,1809,1,14,3153,6,238.906238,0.063158,0.052632,0.010526
3048,191,192,1,ROT,1808,1,30,3154,6,238.969395,0.062827,0.052356,0.010471
3049,192,193,1,ROT,1807,1,1,3155,6,239.032223,0.062500,0.052083,0.010417
3050,193,194,1,ROT,1806,1,32,3156,6,239.094723,0.062176,0.051813,0.010363
3051,194,195,1,ROT,1805,1,7,3157,6,239.156899,0.061856,0.051546,0.010309
3052,195,194,1,ROT,1806,0,22,2924,6,239.218755,0.051282,0.051282,0.010309
3053,194,192,2,SCHWARZ,1808,0,23,3341,6,239.270037,0.206186,0.103093,0.010309
3054,192,188,4,ROT,1812,0,22,2928,6,239.476222,0.833333,0.208333,0.010309
3055,188,196,8,SCHWARZ,1804,1,6,2308,6,240.309555,4.085106,0.425532,0.085106
3056,196,197,1,SCHWARZ,1803,1,17,2309,6,244.394662,0.061224,0.051020,0.010204
3057,197,198,1,SCHWARZ,1802,1,31,2310,6,244.455886,0.060914,0.050761,0.010152
3058,198,197,1,SCHWARZ,1803,0,25,3342,6,244.516800,0.050505,0.050505,0.010152
3059,197,199,2,ROT,1801,1,36,3159,6,244.567305,0.243655,0.101523,0.020305
3060,199,200,1,ROT,1800,1,32,3160,6,244.810960,0.060302,0.050251,0.010050
3061,200,199,1,ROT,1801,0,29,2929,6,244.871261,0.050000,0.050000,0.010050
3062,199,197,2,SCHWARZ,1803,0,36,3344,6,244.921261,0.201005,0.100503,0.010050
3063,197,193,4,ROT,1807,0,11,2933,6,245.122266,0.812183,0.203046,0.010050
3064,193,201,8,SCHWARZ,1799,1,33,2318,6,245.934449,3.979275,0.414508,0.082902
3065,201,202,1,SCHWARZ,1798,1,33,2319,6,249.913724,0.059701,0.049751,0.009950
3066,202,203,1,SCHWARZ,1797,1,4,2320,6,249.973425,0.059406,0.049505,0.009901
3067,203,202,1,SCHWARZ,1798,0,32,3345,6,250.032831,0.049261,0.049261,0.009901
3068,202,200,2,ROT,1800,0,33,2935,6,250.082092,0.198020,0.099010,0.009901
3069,200,204,4,SCHWARZ,1796,1,26,2324,6,250.280112,0.960000,0.200000,0.040000
3070,204,205,1,SCHWARZ,1795,1,24,2325,6,251.240112,0.058824,0.049020,0.009804
3071,205,204,1,SCHWARZ,1796,0,7,3346,6,251.298936,0.048780,0.048780,0.009804
3072,204,202,2,ROT,1798,0,11,2937,6,251.347716,0.196078,0.098039,0.009804
3073,202,206,4,SCHWARZ,1794,1,33,2329,6,251.543795,0.950495,0.198020,0.039604
3074,206,205,1,SCHWARZ,1795,0,9,3347,6,252.494290,0.048544,0.048544,0.039604
3075,205,207,2,ROT,1793,1,21,3162,6,252.542833,0.234146,0.097561,0.019512
3076,207,206,1,ROT,1794,0,0,2938,6,252.776980,0.048309,0.048309,0.019512
3077,206,204,2,SCHWARZ,1796,0,5,3349,6,252.825289,0.194175,0.097087,0.019512
3078,204,200,4,ROT,1800,0,22,2942,6,253.019464,0.784314,0.196078,0.019512
3079,200,208,8,SCHWARZ,1792,1,6,2337,6,253.803777,3.840000,0.400000,0.080000
3080,208,207,1,SCHWARZ,1793,0,34,3350,6,257.643777,0.048077,0.048077,0.080000
3081,207,209,2,ROT,1791,1,1,3164,6,257.691854,0.231884,0.096618,0.019324
3082,209,208,1,ROT,1792,0,20,2943,6,257.923738,0.047847,0.047847,0.019324
3083,208,210,2,SCHWARZ,1790,1,8,2339,6,257.971585,0.230769,0.096154,0.019231
3084,210,211,1,SCHWARZ,1789,1,11,2340,6,258.202354,0.057143,0.047619,0.009524
3085,211,212,1,SCHWARZ,1788,1,15,2341,6,258.259497,0.056872,0.047393,0.009479
3086,212,211,1,SCHWARZ,1789,0,18,3351,6,258.316369,0.047170,0.047170,0.009479
3087,211,213,2,ROT,1787,1,3,3166,6,258.363539,0.227488,0.094787,0.018957
3088,213,212,1,ROT,1788,0,10,2944,6,258.591027,0.046948,0.046948,0.018957
3089,212,210,2,SCHWARZ,1790,0,9,3353,6,258.637976,0.188679,0.094340,0.018957
3090,210,206,4,ROT,1794,0,22,2948,6,258.826655,0.761905,0.190476,0.018957
3091,206,198,8,SCHWARZ,1802,0,18,3361,6,259.588560,3.106796,0.388350,0.018957
3092,198,214,16,ROT,1786,1,19,3182,6,262.695356,15.515152,0.808081,0.161616
3093,214,215,1,ROT,1785,1,30,3183,6,278.210507,0.056075,0.046729,0.009346
3094,215,216,1,ROT,1784,1,30,3184,6,278.266582,0.055814,0.046512,0.009302
3095,216,217,1,ROT,1783,1,27,3185,6,278.322396,0.055556,0.046296,0.009259
3096,217,216,1,ROT,1784,0,15,2949,6,278.377952,0.046083,0.046083,0.009259
3097,216,214,2,SCHWARZ,1786,0,0,3363,6,278.424035,0.185185,0.092593,0.009259
3098,214,210,4,ROT,1790,0,2,2953,6,278.609220,0.747664,0.186916,0.009259
3099,210,202,8,SCHWARZ,1798,0,25,3371,6,279.356883,3.047619,0.380952,0.009259
3100,202,218,16,ROT,1782,1,12,3201,6,282.404502,15.207921,0.792079,0.158416
3101,218,219,1,ROT,1781,1,34,3202,6,297.612423,0.055046,0.045872,0.009174
3102,219,220,1,ROT,1780,1,12,3203,6,297.667469,0.054795,0.045662,0.009132
3103,220,219,1,ROT,1781,0,15,2954,6,297.722264,0.045455,0.045455,0.009132
3104,219,221,2,SCHWARZ,1779,1,22,2343,6,297.767718,0.219178,0.091324,0.018265
3105,221,220,1,SCHWARZ,1780,0,0,3372,6,297.986896,0.045249,0.045249,0.018265
3106,220,222,2,ROT,1778,1,3,3205,6,298.032145,0.218182,0.090909,0.018182
3107,222,223,1,ROT,1777,1,9,3206,6,298.250327,0.054054,0.045045,0.009009
3108,223,222,1,ROT,1778,0,10,2955,6,298.304381,0.044843,0.044843,0.009009
3109,222,224,2,SCHWARZ,1776,1,29,2345,6,298.349224,0.216216,0.090090,0.018018
3110,224,225,1,SCHWARZ,1775,1,28,2346,6,298.565440,0.053571,0.044643,0.008929
3111,225,226,1,SCHWARZ,1774,1,13,2347,6,298.619012,0.053333,0.044444,0.008889
3112,226,225,1,SCHWARZ,1775,0,25,3373,6,298.672345,0.044248,0.044248,0.008889
3113,225,227,2,ROT,1773,1,12,3208,6,298.716593,0.213333,0.088889,0.017778
3114,227,226,1,ROT,1774,0,8,2956,6,298.929926,0.044053,0.044053,0.017778
3115,226,228,2,SCHWARZ,1772,1,11,2349,6,298.973979,0.212389,0.088496,0.017699
3116,228,227,1,SCHWARZ,1773,0,1,3374,6,299.186368,0.043860,0.043860,0.017699
3117,227,229,2,ROT,1771,1,7,3210,6,299.230228,0.211454,0.088106,0.017621
3118,229,230,1,ROT,1770,1,30,3211,6,299.441682,0.052402,0.043668,0.008734
3119,230,231,1,ROT,1769,1,9,3212,6,299.494083,0.052174,0.043478,0.008696
3120,231,230,1,ROT,1770,0,28,2957,6,299.546257,0.043290,0.043290,0.008696
3121,230,228,2,SCHWARZ,1772,0,1,3376,6,299.589547,0.173913,0.086957,0.008696
3122,228,224,4,ROT,1776,0,33,2961,6,299.763460,0.701754,0.175439,0.008696
3123,224,232,8,SCHWARZ,1768,1,2,2357,6,300.465215,3.428571,0.357143,0.071429
3124,232,231,1,SCHWARZ,1769,0,5,3377,6,303.893786,0.043103,0.043103,0.071429
3125,231,233,2,ROT,1767,1,3,3214,6,303.936890,0.207792,0.086580,0.017316
3126,233,232,1,ROT,1768,0,35,2962,6,304.144682,0.042918,0.042918,0.017316
3127,232,234,2,SCHWARZ,1766,1,15,2359,6,304.187600,0.206897,0.086207,0.017241
3128,234,233,1,SCHWARZ,1767,0,36,3378,6,304.394497,0.042735,0.042735,0.017241
3129,233,235,2,ROT,1765,1,30,3216,6,304.437232,0.206009,0.085837,0.017167
3130,235,236,1,ROT,1764,1,1,3217,6,304.643241,0.051064,0.042553,0.008511
3131,236,237,1,ROT,1763,1,12,3218,6,304.694304,0.050847,0.042373,0.008475
3132,237,238,1,ROT,1762,1,7,3219,6,304.745152,0.050633,0.042194,0.008439
3133,238,239,1,ROT,1761,1,30,3220,6,304.795785,0.050420,0.042017,0.008403
3134,239,240,1,ROT,1760,1,18,3221,6,304.846205,0.050209,0.041841,0.008368
3135,240,241,1,ROT,1759,1,5,3222,6,304.896414,0.050000,0.041667,0.008333
3136,241,240,1,ROT,1760,0,33,2963,6,304.946414,0.041494,0.041494,0.008333
3137,240,238,2,SCHWARZ,1762,0,32,3380,6,304.987908,0.166667,0.083333,0.008333
3138,238,242,4,ROT,1758,1,21,3226,6,305.154575,0.806723,0.168067,0.033613
3139,242,243,1,ROT,1757,1,18,3227,6,305.961297,0.049587,0.041322,0.008264
3140,243,244,1,ROT,1756,1,9,3228,6,306.010884,0.049383,0.041152,0.008230
3141,244,243,1,ROT,1757,0,20,2964,6,306.060267,0.040984,0.040984,0.008230
3142,243,245,2,SCHWARZ,1755,1,11,2361,6,306.101250,0.197531,0.082305,0.016461
3143,245,246,1,SCHWARZ,1754,1,29,2362,6,306.298781,0.048980,0.040816,0.008163
3144,246,247,1,SCHWARZ,1753,1,6,2363,6,306.347761,0.048780,0.040650,0.008130
3145,247,248,1,SCHWARZ,1752,1,29,2364,6,306.396541,0.048583,0.040486,0.008097
3146,248,249,1,SCHWARZ,1751,1,2,2365,6,306.445124,0.048387,0.040323,0.008065
3147,249,248,1,SCHWARZ,1752,0,7,3381,6,306.493511,0.040161,0.040161,0.008065
3148,248,250,2,ROT,1750,1,25,3230,6,306.533672,0.193548,0.080645,0.016129
3149,250,249,1,ROT,1751,0,8,2965,6,306.727220,0.040000,0.040000,0.016129
3150,249,251,2,SCHWARZ,1749,1,26,2367,6,306.767220,0.192771,0.080321,0.016064
3151,251,250,1,SCHWARZ,1750,0,18,3382,6,306.959992,0.039841,0.039841,0.016064
3152,250,252,2,ROT,1748,1,1,3232,6,306.999832,0.192000,0.080000,0.016000
3153,252,253,1,ROT,1747,1,5,3233,6,307.191832,0.047619,0.039683,0.007937
3154,253,252,1,ROT,1748,0,31,2966,6,307.239451,0.039526,0.039526,0.007937
3155,252,250,2,SCHWARZ,1750,0,19,3384,6,307.278977,0.158730,0.079365,0.007937
3156,250,246,4,ROT,1754,0,28,2970,6,307.437707,0.640000,0.160000,0.007937
3157,246,238,8,SCHWARZ,1762,0,14,3392,6,308.077707,2.601626,0.325203,0.007937
3158,238,254,16,ROT,1746,1,30,3249,6,310.679333,12.907563,0.672269,0.134454
3159,254,255,1,ROT,1745,1,30,3250,6,323.586896,0.047244,0.039370,0.007874
3160,255,256,1,ROT,1744,1,34,3251,6,323.634140,0.047059,0.039216,0.007843
3161,256,255,1,ROT,1745,0,6,2971,6,323.681199,0.039062,0.039062,0.007843
3162,255,257,2,SCHWARZ,1743,1,15,2369,6,323.720262,0.188235,0.078431,0.015686
3163,257,256,1,SCHWARZ,1744,0,36,3393,6,323.908497,0.038911,0.038911,0.015686
3164,256,254,2,ROT,1746,0,17,2973,6,323.947407,0.156250,0.078125,0.015686
3165,254,258,4,SCHWARZ,1742,1,28,2373,6,324.103657,0.755906,0.157480,0.031496
3166,258,257,1,SCHWARZ,1743,0,5,3394,6,324.859563,0.038760,0.038760,0.031496
3167,257,255,2,ROT,1745,0,28,2975,6,324.898323,0.155642,0.077821,0.031496
3168,255,251,4,SCHWARZ,1749,0,21,3398,6,325.053965,0.627451,0.156863,0.031496
3169,251,243,8,ROT,1757,0,22,2983,6,325.681416,2.549801,0.318725,0.031496
3170,243,227,16,SCHWARZ,1773,0,0,3414,6,328.231216,10.534979,0.658436,0.031496
3171,227,259,32,ROT,1741,1,25,3283,6,338.766196,54.132159,1.409692,0.281938
3172,259,258,1,ROT,1742,0,33,2984,6,392.898355,0.038610,0.038610,0.281938
3173,258,260,2,SCHWARZ,1740,1,33,2375,6,392.936965,0.186047,0.077519,0.015504
3174,260,259,1,SCHWARZ,1741,0,12,3415,6,393.123011,0.038462,0.038462,0.015504
3175,259,261,2,ROT,1739,1,21,3285,6,393.161473,0.185328,0.077220,0.015444
3176,261,260,1,ROT,1740,0,26,2985,6,393.346801,0.038314,0.038314,0.015444
3177,260,262,2,SCHWARZ,1738,1,26,2377,6,393.385115,0.184615,0.076923,0.015385
3178,262,263,1,SCHWARZ,1737,1,22,2378,6,393.569730,0.045802,0.038168,0.007634
3179,263,264,1,SCHWARZ,1736,1,22,2379,6,393.615532,0.045627,0.038023,0.007605
3180,264,265,1,SCHWARZ,1735,1,11,2380,6,393.661159,0.045455,0.037879,0.007576
3181,265,264,1,SCHWARZ,1736,0,0,3416,6,393.706614,0.037736,0.037736,0.007576
3182,264,266,2,ROT,1734,1,9,3287,6,393.744350,0.181818,0.075758,0.015152
3183,266,267,1,ROT,1733,1,34,3288,6,393.926168,0.045113,0.037594,0.007519
3184,267,268,1,ROT,1732,1,16,3289,6,393.971281,0.044944,0.037453,0.007491
3185,268,267,1,ROT,1733,0,10,2986,6,394.016224,0.037313,0.037313,0.007491
3186,267,269,2,SCHWARZ,1731,1,33,2382,6,394.053538,0.179775,0.074906,0.014981
3187,269,268,1,SCHWARZ,1732,0,9,3417,6,394.233313,0.037175,0.037175,0.014981
3188,268,266,2,ROT,1734,0,29,2988,6,394.270488,0.149254,0.074627,0.014981
3189,266,270,4,SCHWARZ,1730,1,20,2386,6,394.419742,0.721805,0.150376,0.030075
3190,270,271,1,SCHWARZ,1729,1,29,2387,6,395.141546,0.044444,0.037037,0.007407
3191,271,272,1,SCHWARZ,1728,1,24,2388,6,395.185991,0.044280,0.036900,0.007380
3192,272,271,1,SCHWARZ,1729,0,7,3418,6,395.230271,0.036765,0.036765,0.007380
3193,271,273,2,ROT,1727,1,18,3291,6,395.267036,0.177122,0.073801,0.014760
3194,273,272,1,ROT,1728,0,17,2989,6,395.444158,0.036630,0.036630,0.014760
3195,272,274,2,SCHWARZ,1726,1,2,2390,6,395.480788,0.176471,0.073529,0.014706
3196,274,273,1,SCHWARZ,1727,0,9,3419,6,395.657258,0.036496,0.036496,0.014706
3197,273,275,2,ROT,1725,1,3,3293,6,395.693754,0.175824,0.073260,0.014652
3198,275,276,1,ROT,1724,1,9,3294,6,395.869579,0.043636,0.036364,0.007273
3199,276,275,1,ROT,1725,0,17,2990,6,395.913215,0.036232,0.036232,0.007273
3200,275,277,2,SCHWARZ,1723,1,15,2392,6,395.949447,0.174545,0.072727,0.014545
3201,277,276,1,SCHWARZ,1724,0,30,3420,6,396.123992,0.036101,0.036101,0.014545
3202,276,274,2,ROT,1726,0,22,2992,6,396.160093,0.144928,0.072464,0.014545
3203,274,270,4,SCHWARZ,1730,0,30,3424,6,396.305021,0.583942,0.145985,0.014545
3204,270,278,8,ROT,1722,1,7,3302,6,396.888963,2.844444,0.296296,0.059259
3205,278,279,1,ROT,1721,1,1,3303,6,399.733407,0.043165,0.035971,0.007194
3206,279,278,1,ROT,1722,0,15,2993,6,399.776573,0.035842,0.035842,0.007194
3207,278,280,2,SCHWARZ,1720,1,11,2394,6,399.812415,0.172662,0.071942,0.014388
3208,280,281,1,SCHWARZ,1719,1,24,2395,6,399.985077,0.042857,0.035714,0.007143
3209,281,282,1,SCHWARZ,1718,1,24,2396,6,400.027934,0.042705,0.035587,0.007117
3210,282,281,1,SCHWARZ,1719,0,27,3425,6,400.070638,0.035461,0.035461,0.007117
3211,281,283,2,ROT,1717,1,18,3305,6,400.106099,0.170819,0.071174,0.014235
3212,283,284,1,ROT,1716,1,21,3306,6,400.276918,0.042403,0.035336,0.007067
3213,284,285,1,ROT,1715,1,36,3307,6,400.319321,0.042254,0.035211,0.007042
3214,285,286,1,ROT,1714,1,18,3308,6,400.361574,0.042105,0.035088,0.007018
3215,286,287,1,ROT,1713,1,18,3309,6,400.403680,0.041958,0.034965,0.006993
3216,287,288,1,ROT,1712,1,14,3310,6,400.445638,0.041812,0.034843,0.006969
3217,288,287,1,ROT,1713,0,6,2994,6,400.487449,0.034722,0.034722,0.006969
3218,287,285,2,SCHWARZ,1715,0,23,3427,6,400.522172,0.139373,0.069686,0.006969
3219,285,289,4,ROT,1711,1,12,3314,6,400.661544,0.673684,0.140351,0.028070
3220,289,288,1,ROT,1712,0,6,2995,6,401.335229,0.034602,0.034602,0.028070
3221,288,290,2,SCHWARZ,1710,1,33,2398,6,401.369831,0.166667,0.069444,0.013889
3222,290,289,1,SCHWARZ,1711,0,21,3428,6,401.536497,0.034483,0.034483,0.013889
3223,289,287,2,ROT,1713,0,35,2997,6,401.570980,0.138408,0.069204,0.013889
3224,287,291,4,SCHWARZ,1709,1,22,2402,6,401.709389,0.668990,0.139373,0.027875
3225,291,292,1,SCHWARZ,1708,1,4,2403,6,402.378378,0.041237,0.034364,0.006873
3226,292,293,1,SCHWARZ,1707,1,22,2404,6,402.419615,0.041096,0.034247,0.006849
3227,293,294,1,SCHWARZ,1706,1,6,2405,6,402.460711,0.040956,0.034130,0.006826
3228,294,295,1,SCHWARZ,1705,1,24,2406,6,402.501667,0.040816,0.034014,0.006803
3229,295,294,1,SCHWARZ,1706,0,36,3429,6,402.542483,0.033898,0.033898,0.006803
3230,294,296,2,ROT,1704,1,18,3316,6,402.576381,0.163265,0.068027,0.013605
3231,296,297,1,ROT,1703,1,3,3317,6,402.739647,0.040541,0.033784,0.006757
3232,297,296,1,ROT,1704,0,28,2998,6,402.780187,0.033670,0.033670,0.006757
3233,296,294,2,SCHWARZ,1706,0,23,3431,6,402.813857,0.135135,0.067568,0.006757
3234,294,298,4,ROT,1702,1,5,3321,6,402.948992,0.653061,0.136054,0.027211
3235,298,299,1,ROT,1701,1,34,3322,6,403.602054,0.040268,0.033557,0.006711
3236,299,300,1,ROT,1700,1,9,3323,6,403.642322,0.040134,0.033445,0.006689
3237,300,301,1,ROT,1699,1,14,3324,6,403.682456,0.040000,0.033333,0.006667
3238,301,300,1,ROT,1700,0,0,2999,6,403.722456,0.033223,0.033223,0.006667
3239,300,302,2,SCHWARZ,1698,1,17,2408,6,403.755678,0.160000,0.066667,0.013333
3240,302,301,1,SCHWARZ,1699,0,21,3432,6,403.915678,0.033113,0.033113,0.013333
3241,301,303,2,ROT,1697,1,25,3326,6,403.948791,0.159468,0.066445,0.013289
3242,303,302,1,ROT,1698,0,8,3000,6,404.108259,0.033003,0.033003,0.013289
3243,302,304,2,SCHWARZ,1696,1,2,2410,6,404.141263,0.158940,0.066225,0.013245
3244,304,305,1,SCHWARZ,1695,1,11,2411,6,404.300203,0.039474,0.032895,0.006579
3245,305,304,1,SCHWARZ,1696,0,36,3433,6,404.339677,0.032787,0.032787,0.006579
3246,304,306,2,ROT,1694,1,3,3328,6,404.372464,0.157895,0.065789,0.013158
3247,306,305,1,ROT,1695,0,4,3001,6,404.530358,0.032680,0.032680,0.013158
3248,305,307,2,SCHWARZ,1693,1,33,2413,6,404.563038,0.157377,0.065574,0.013115
3249,307,306,1,SCHWARZ,1694,0,14,3434,6,404.720415,0.032573,0.032573,0.013115
3250,306,304,2,ROT,1696,0,2,3003,6,404.752988,0.130719,0.065359,0.013115
3251,304,308,4,SCHWARZ,1692,1,26,2417,6,404.883707,0.631579,0.131579,0.026316
3252,308,309,1,SCHWARZ,1691,1,6,2418,6,405.515286,0.038961,0.032468,0.006494
3253,309,310,1,SCHWARZ,1690,1,22,2419,6,405.554247,0.038835,0.032362,0.006472
3254,310,309,1,SCHWARZ,1691,0,27,3435,6,405.593082,0.032258,0.032258,0.006472
3255,309,307,2,ROT,1693,0,33,3005,6,405.625340,0.129450,0.064725,0.006472
3256,307,311,4,SCHWARZ,1689,1,31,2423,6,405.754790,0.625407,0.130293,0.026059
3257,311,312,1,SCHWARZ,1688,1,13,2424,6,406.380197,0.038585,0.032154,0.006431
3258,312,311,1,SCHWARZ,1689,0,36,3436,6,406.418783,0.032051,0.032051,0.006431
3259,311,309,2,ROT,1691,0,8,3007,6,406.450834,0.128617,0.064309,0.006431
3260,309,313,4,SCHWARZ,1687,1,35,2428,6,406.579451,0.621359,0.129450,0.025890
3261,313,312,1,SCHWARZ,1688,0,23,3437,6,407.200811,0.031949,0.031949,0.025890
3262,312,310,2,ROT,1690,0,35,3009,6,407.232759,0.128205,0.064103,0.025890
3263,310,314,4,SCHWARZ,1686,1,29,2432,6,407.360965,0.619355,0.129032,0.025806
3264,314,313,1,SCHWARZ,1687,0,36,3438,6,407.980319,0.031847,0.031847,0.025806
3265,313,311,2,ROT,1689,0,33,3011,6,408.012167,0.127796,0.063898,0.025806
3266,311,315,4,SCHWARZ,1685,1,6,2436,6,408.139962,0.617363,0.128617,0.025723
3267,315,316,1,SCHWARZ,1684,1,29,2437,6,408.757325,0.038095,0.031746,0.006349
3268,316,315,1,SCHWARZ,1685,0,36,3439,6,408.795421,0.031646,0.031646,0.006349
3269,315,313,2,ROT,1687,0,22,3013,6,408.827066,0.126984,0.063492,0.006349
3270,313,309,4,SCHWARZ,1691,0,12,3443,6,408.954050,0.511182,0.127796,0.006349
3271,309,301,8,ROT,1699,0,28,3021,6,409.465232,2.071197,0.258900,0.006349
3272,301,285,16,SCHWARZ,1715,0,23,3459,6,411.536430,8.504983,0.531561,0.006349
3273,285,317,32,ROT,1683,1,16,3360,6,420.041413,43.115790,1.122807,0.224561
3274,317,316,1,ROT,1684,0,31,3022,6,463.157203,0.031546,0.031546,0.224561
3275,316,314,2,SCHWARZ,1686,0,23,3461,6,463.188749,0.126582,0.063291,0.224561
3276,314,310,4,ROT,1690,0,35,3026,6,463.315331,0.509554,0.127389,0.224561
3277,310,302,8,SCHWARZ,1698,0,7,3469,6,463.824885,2.064516,0.258065,0.224561
3278,302,318,16,ROT,1682,1,5,3376,6,465.889401,10.172185,0.529801,0.105960
3279,318,319,1,ROT,1681,1,32,3377,6,476.061587,0.037736,0.031447,0.006289
3280,319,320,1,ROT,1680,1,9,3378,6,476.099322,0.037618,0.031348,0.006270
3281,320,321,1,ROT,1679,1,3,3379,6,476.136940,0.037500,0.031250,0.006250
3282,321,320,1,ROT,1680,0,33,3027,6,476.174440,0.031153,0.031153,0.006250
3283,320,318,2,SCHWARZ,1682,0,23,3471,6,476.205593,0.125000,0.062500,0.006250
3284,318,314,4,ROT,1686,0,4,3031,6,476.330593,0.503145,0.125786,0.006250
3285,314,322,8,SCHWARZ,1678,1,26,2445,6,476.833737,2.445860,0.254777,0.050955
3286,322,323,1,SCHWARZ,1677,1,29,2446,6,479.279597,0.037267,0.031056,0.006211
3287,323,322,1,SCHWARZ,1678,0,1,3472,6,479.316864,0.030960,0.030960,0.006211
3288,322,324,2,ROT,1676,1,3,3381,6,479.347824,0.149068,0.062112,0.012422
3289,324,323,1,ROT,1677,0,29,3032,6,479.496892,0.030864,0.030864,0.012422
3290,323,325,2,SCHWARZ,1675,1,13,2448,6,479.527757,0.148607,0.061920,0.012384
3291,325,324,1,SCHWARZ,1676,0,21,3473,6,479.676363,0.030769,0.030769,0.012384
3292,324,326,2,ROT,1674,1,27,3383,6,479.707133,0.148148,0.061728,0.012346
3293,326,327,1,ROT,1673,1,5,3384,6,479.855281,0.036810,0.030675,0.006135
3294,327,328,1,ROT,1672,1,34,3385,6,479.892091,0.036697,0.030581,0.006116
3295,328,329,1,ROT,1671,1,16,3386,6,479.928788,0.036585,0.030488,0.006098
3296,329,328,1,ROT,1672,0,33,3033,6,479.965373,0.030395,0.030395,0.006098
3297,328,326,2,SCHWARZ,1674,0,3,3475,6,479.995768,0.121951,0.060976,0.006098
3298,326,330,4,ROT,1670,1,21,3390,6,480.117719,0.588957,0.122699,0.024540
3299,330,329,1,ROT,1671,0,6,3034,6,480.706677,0.030303,0.030303,0.024540
3300,329,331,2,SCHWARZ,1669,1,4,2450,6,480.736980,0.145897,0.060790,0.012158
3301,331,330,1,SCHWARZ,1670,0,23,3476,6,480.882876,0.030211,0.030211,0.012158
3302,330,328,2,ROT,1672,0,35,3036,6,480.913088,0.121212,0.060606,0.012158
3303,328,324,4,SCHWARZ,1676,0,16,3480,6,481.034300,0.487805,0.121951,0.012158
3304,324,316,8,ROT,1684,0,29,3044,6,481.522105,1.975309,0.246914,0.012158
3305,316,300,16,SCHWARZ,1700,0,9,3496,6,483.497413,8.101266,0.506329,0.012158
3306,300,332,32,ROT,1668,1,36,3422,6,491.598679,40.960000,1.066667,0.213333
3307,332,331,1,ROT,1669,0,35,3045,6,532.558679,0.030120,0.030120,0.213333
3308,331,333,2,SCHWARZ,1667,1,33,2452,6,532.588800,0.145015,0.060423,0.012085
3309,333,334,1,SCHWARZ,1666,1,15,2453,6,532.733815,0.036036,0.030030,0.006006
3310,334,333,1,SCHWARZ,1667,0,25,3497,6,532.769851,0.029940,0.029940,0.006006
3311,333,335,2,ROT,1665,1,25,3424,6,532.799791,0.144144,0.060060,0.012012
3312,335,334,1,ROT,1666,0,33,3046,6,532.943935,0.029851,0.029851,0.012012
3313,334,336,2,SCHWARZ,1664,1,20,2455,6,532.973786,0.143713,0.059880,0.011976
3314,336,335,1,SCHWARZ,1665,0,30,3498,6,533.117498,0.029762,0.029762,0.011976
3315,335,333,2,ROT,1667,0,29,3048,6,533.147260,0.119403,0.059701,0.011976
3316,333,329,4,SCHWARZ,1671,0,7,3502,6,533.266663,0.480480,0.120120,0.011976
3317,329,321,8,ROT,1679,0,8,3056,6,533.747144,1.945289,0.243161,0.011976
3318,321,305,16,SCHWARZ,1695,0,3,3518,6,535.692433,7.975078,0.498442,0.011976
3319,305,337,32,ROT,1663,1,16,3456,6,543.667510,40.288525,1.049180,0.209836
3320,337,336,1,ROT,1664,0,22,3057,6,583.956035,0.029674,0.029674,0.209836
3321,336,334,2,SCHWARZ,1666,0,7,3520,6,583.985709,0.119048,0.059524,0.209836
3322,334,330,4,ROT,1670,0,10,3061,6,584.104756,0.479042,0.119760,0.209836
3323,330,322,8,SCHWARZ,1678,0,30,3528,6,584.583798,1.939394,0.242424,0.209836
3324,322,306,16,ROT,1694,0,20,3077,6,586.523192,7.950311,0.496894,0.209836
3325,306,338,32,SCHWARZ,1662,1,20,2487,6,594.473503,40.156863,1.045752,0.209150
3326,338,339,1,SCHWARZ,1661,1,20,2488,6,634.630366,0.035503,0.029586,0.005917
3327,339,340,1,SCHWARZ,1660,1,22,2489,6,634.665869,0.035398,0.029499,0.005900
3328,340,341,1,SCHWARZ,1659,1,22,2490,6,634.701267,0.035294,0.029412,0.005882
3329,341,340,1,SCHWARZ,1660,0,23,3529,6,634.736561,0.029326,0.029326,0.005882
3330,340,342,2,ROT,1658,1,18,3458,6,634.765886,0.141176,0.058824,0.011765
3331,342,341,1,ROT,1659,0,33,3078,6,634.907063,0.029240,0.029240,0.011765
3332,341,339,2,SCHWARZ,1661,0,18,3531,6,634.936303,0.117302,0.058651,0.011765
3333,339,335,4,ROT,1665,0,29,3082,6,635.053605,0.471976,0.117994,0.011765
3334,335,327,8,SCHWARZ,1673,0,19,3539,6,635.525581,1.910448,0.238806,0.011765
3335,327,343,16,ROT,1657,1,34,3474,6,637.436029,9.394495,0.489297,0.097859
3336,343,342,1,ROT,1658,0,29,3083,6,646.830524,0.029155,0.029155,0.097859
3337,342,340,2,SCHWARZ,1660,0,14,3541,6,646.859679,0.116959,0.058480,0.097859
3338,340,336,4,ROT,1664,0,11,3087,6,646.976638,0.470588,0.117647,0.097859
3339,336,328,8,SCHWARZ,1672,0,5,3549,6,647.447226,1.904762,0.238095,0.097859
3340,328,344,16,ROT,1656,1,25,3490,6,649.351988,9.365854,0.487805,0.097561
3341,344,343,1,ROT,1657,0,35,3088,6,658.717842,0.029070,0.029070,0.097561
3342,343,341,2,SCHWARZ,1659,0,1,3551,6,658.746912,0.116618,0.058309,0.097561
3343,341,345,4,ROT,1655,1,30,3494,6,658.863530,0.563050,0.117302,0.023460
3344,345,346,1,ROT,1654,1,16,3495,6,659.426579,0.034783,0.028986,0.005797
3345,346,347,1,ROT,1653,1,16,3496,6,659.461362,0.034682,0.028902,0.005780
3346,347,348,1,ROT,1652,1,14,3497,6,659.496044,0.034582,0.028818,0.005764
3347,348,347,1,ROT,1653,0,24,3089,6,659.530626,0.028736,0.028736,0.005764
3348,347,349,2,SCHWARZ,1651,1,13,2492,6,659.559362,0.138329,0.057637,0.011527
3349,349,348,1,SCHWARZ,1652,0,7,3552,6,659.697690,0.028653,0.028653,0.011527
3350,348,346,2,ROT,1654,0,13,3091,6,659.726344,0.114943,0.057471,0.011527
3351,346,342,4,SCHWARZ,1658,0,1,3556,6,659.841286,0.462428,0.115607,0.011527
3352,342,334,8,ROT,1666,0,24,3099,6,660.303714,1.871345,0.233918,0.011527
3353,334,318,16,SCHWARZ,1682,0,14,3572,6,662.175059,7.664671,0.479042,0.011527
3354,318,286,32,ROT,1714,0,0,3131,6,669.839730,32.201258,1.006289,0.011527
3355,286,222,64,SCHWARZ,1778,0,1,3636,6,702.040988,143.216783,2.237762,0.011527
3356,222,221,1,ROT,1779,0,20,3132,6,845.257771,0.045045,0.045045,0.011527
3357,221,219,2,SCHWARZ,1781,0,36,3638,6,845.302816,0.180995,0.090498,0.011527
3358,219,223,4,ROT,1777,1,14,3501,6,845.483811,0.876712,0.182648,0.036530
3359,223,224,1,ROT,1776,1,32,3502,6,846.360524,0.053812,0.044843,0.008969
3360,224,223,1,ROT,1777,0,22,3133,6,846.414335,0.044643,0.044643,0.008969
3361,223,221,2,SCHWARZ,1779,0,16,3640,6,846.458978,0.179372,0.089686,0.008969
3362,221,217,4,ROT,1783,0,11,3137,6,846.638350,0.723982,0.180995,0.008969
3363,217,225,8,SCHWARZ,1775,1,8,2500,6,847.362332,3.539171,0.368664,0.073733
3364,225,226,1,SCHWARZ,1774,1,6,2501,6,850.901503,0.053333,0.044444,0.008889
3365,226,227,1,SCHWARZ,1773,1,2,2502,6,850.954836,0.053097,0.044248,0.008850
3366,227,226,1,SCHWARZ,1774,0,7,3641,6,851.007933,0.044053,0.044053,0.008850
3367,226,224,2,ROT,1776,0,11,3139,6,851.051986,0.176991,0.088496,0.008850
3368,224,220,4,SCHWARZ,1780,0,32,3645,6,851.228977,0.714286,0.178571,0.008850
3369,220,228,8,ROT,1772,1,14,3510,6,851.943263,3.490909,0.363636,0.072727
3370,228,227,1,ROT,1773,0,28,3140,6,855.434172,0.043860,0.043860,0.072727
3371,227,229,2,SCHWARZ,1771,1,15,2504,6,855.478032,0.211454,0.088106,0.017621
3372,229,230,1,SCHWARZ,1770,1,17,2505,6,855.689486,0.052402,0.043668,0.008734
3373,230,229,1,SCHWARZ,1771,0,36,3646,6,855.741887,0.043478,0.043478,0.008734
3374,229,227,2,ROT,1773,0,28,3142,6,855.785366,0.174672,0.087336,0.008734
3375,227,231,4,SCHWARZ,1769,1,17,2509,6,855.960038,0.845815,0.176211,0.035242
3376,231,230,1,SCHWARZ,1770,0,18,3647,6,856.805853,0.043290,0.043290,0.035242
3377,230,232,2,ROT,1768,1,30,3512,6,856.849143,0.208696,0.086957,0.017391
3378,232,233,1,ROT,1767,1,18,3513,6,857.057839,0.051724,0.043103,0.008621
3379,233,232,1,ROT,1768,0,35,3143,6,857.109563,0.042918,0.042918,0.008621
3380,232,234,2,SCHWARZ,1766,1,35,2511,6,857.152481,0.206897,0.086207,0.017241
3381,234,235,1,SCHWARZ,1765,1,35,2512,6,857.359378,0.051282,0.042735,0.008547
3382,235,234,1,SCHWARZ,1766,0,30,3648,6,857.410660,0.042553,0.042553,0.008547
3383,234,232,2,ROT,1768,0,10,3145,6,857.453213,0.170940,0.085470,0.008547
3384,232,236,4,SCHWARZ,1764,1,11,2516,6,857.624153,0.827586,0.172414,0.034483
3385,236,235,1,SCHWARZ,1765,0,34,3649,6,858.451740,0.042373,0.042373,0.034483
3386,235,237,2,ROT,1763,1,7,3515,6,858.494112,0.204255,0.085106,0.017021
3387,237,238,1,ROT,1762,1,14,3516,6,858.698368,0.050633,0.042194,0.008439
3388,238,237,1,ROT,1763,0,13,3146,6,858.749001,0.042017,0.042017,0.008439
3389,237,239,2,SCHWARZ,1761,1,4,2518,6,858.791018,0.202532,0.084388,0.016878
3390,239,238,1,SCHWARZ,1762,0,25,3650,6,858.993549,0.041841,0.041841,0.016878
3391,238,240,2,ROT,1760,1,14,3518,6,859.035390,0.201681,0.084034,0.016807
3392,240,239,1,ROT,1761,0,8,3147,6,859.237071,0.041667,0.041667,0.016807
3393,239,237,2,SCHWARZ,1763,0,1,3652,6,859.278738,0.167364,0.083682,0.016807
3394,237,241,4,ROT,1759,1,1,3522,6,859.446102,0.810127,0.168776,0.033755
3395,241,240,1,ROT,1760,0,11,3148,6,860.256228,0.041494,0.041494,0.033755
3396,240,238,2,SCHWARZ,1762,0,0,3654,6,860.297722,0.166667,0.083333,0.033755
3397,238,242,4,ROT,1758,1,16,3526,6,860.464389,0.806723,0.168067,0.033613
3398,242,241,1,ROT,1759,0,11,3149,6,861.271111,0.041322,0.041322,0.033613
3399,241,243,2,SCHWARZ,1757,1,35,2520,6,861.312434,0.199170,0.082988,0.016598
3400,243,242,1,SCHWARZ,1758,0,19,3655,6,861.511604,0.041152,0.041152,0.016598
3401,242,240,2,ROT,1760,0,20,3151,6,861.552756,0.165289,0.082645,0.016598
3402,240,244,4,SCHWARZ,1756,1,26,2524,6,861.718045,0.800000,0.166667,0.033333
3403,244,243,1,SCHWARZ,1757,0,12,3656,6,862.518045,0.040984,0.040984,0.033333
3404,243,245,2,ROT,1755,1,21,3528,6,862.559029,0.197531,0.082305,0.016461
3405,245,246,1,ROT,1754,1,32,3529,6,862.756560,0.048980,0.040816,0.008163
3406,246,245,1,ROT,1755,0,20,3152,6,862.805539,0.040650,0.040650,0.008163
3407,245,247,2,SCHWARZ,1753,1,13,2526,6,862.846190,0.195918,0.081633,0.016327
3408,247,248,1,SCHWARZ,1752,1,11,2527,6,863.042108,0.048583,0.040486,0.008097
3409,248,249,1,SCHWARZ,1751,1,17,2528,6,863.090691,0.048387,0.040323,0.008065
3410,249,248,1,SCHWARZ,1752,0,14,3657,6,863.139078,0.040161,0.040161,0.008065
3411,248,246,2,ROT,1754,0,17,3154,6,863.179239,0.161290,0.080645,0.008065
3412,246,250,4,SCHWARZ,1750,1,17,2532,6,863.340529,0.780488,0.162602,0.032520
3413,250,249,1,SCHWARZ,1751,0,0,3658,6,864.121017,0.040000,0.040000,0.032520
3414,249,247,2,ROT,1753,0,29,3156,6,864.161017,0.160643,0.080321,0.032520
3415,247,243,4,SCHWARZ,1757,0,16,3662,6,864.321659,0.647773,0.161943,0.032520
3416,243,235,8,ROT,1765,0,15,3164,6,864.969433,2.633745,0.329218,0.032520
3417,235,251,16,SCHWARZ,1749,1,31,2548,6,867.603178,13.072340,0.680851,0.136170
3418,251,252,1,SCHWARZ,1748,1,13,2549,6,880.675518,0.047809,0.039841,0.007968
3419,252,251,1,SCHWARZ,1749,0,23,3663,6,880.723327,0.039683,0.039683,0.007968
3420,251,249,2,ROT,1751,0,29,3166,6,880.763009,0.159363,0.079681,0.007968
3421,249,245,4,SCHWARZ,1755,0,12,3667,6,880.922372,0.642570,0.160643,0.007968
3422,245,253,8,ROT,1747,1,25,3537,6,881.564942,3.134694,0.326531,0.065306
3423,253,254,1,ROT,1746,1,16,3538,6,884.699636,0.047431,0.039526,0.007905
3424,254,255,1,ROT,1745,1,21,3539,6,884.747067,0.047244,0.039370,0.007874
3425,255,254,1,ROT,1746,0,22,3167,6,884.794311,0.039216,0.039216,0.007874
3426,254,252,2,SCHWARZ,1748,0,21,3669,6,884.833527,0.157480,0.078740,0.007874
3427,252,256,4,ROT,1744,1,1,3543,6,884.991007,0.761905,0.158730,0.031746
3428,256,255,1,ROT,1745,0,33,3168,6,885.752912,0.039062,0.039062,0.031746
3429,255,257,2,SCHWARZ,1743,1,22,2551,6,885.791974,0.188235,0.078431,0.015686
3430,257,258,1,SCHWARZ,1742,1,29,2552,6,885.980210,0.046693,0.038911,0.007782
3431,258,259,1,SCHWARZ,1741,1,33,2553,6,886.026902,0.046512,0.038760,0.007752
3432,259,258,1,SCHWARZ,1742,0,7,3670,6,886.073414,0.038610,0.038610,0.007752
3433,258,260,2,ROT,1740,1,25,3545,6,886.112024,0.186047,0.077519,0.015504
3434,260,261,1,ROT,1739,1,18,3546,6,886.298070,0.046154,0.038462,0.007692
3435,261,262,1,ROT,1738,1,7,3547,6,886.344224,0.045977,0.038314,0.007663
3436,262,261,1,ROT,1739,0,22,3169,6,886.390201,0.038168,0.038168,0.007663
3437,261,259,2,SCHWARZ,1741,0,19,3672,6,886.428369,0.153257,0.076628,0.007663
3438,259,255,4,ROT,1745,0,6,3173,6,886.581626,0.617761,0.154440,0.007663
3439,255,247,8,SCHWARZ,1753,0,36,3680,6,887.199386,2.509804,0.313725,0.007663
3440,247,231,16,ROT,1769,0,11,3189,6,889.709190,10.364372,0.647773,0.007663
3441,231,199,32,SCHWARZ,1801,0,23,3712,6,900.073563,44.329004,1.385281,0.007663
3442,199,263,64,ROT,1737,1,34,3611,6,944.402567,246.994975,3.216080,0.643216
3443,263,264,1,ROT,1736,1,9,3612,6,1191.397543,0.045627,0.038023,0.007605
3444,264,265,1,ROT,1735,1,30,3613,6,1191.443170,0.045455,0.037879,0.007576
3445,265,266,1,ROT,1734,1,25,3614,6,1191.488625,0.045283,0.037736,0.007547
3446,266,265,1,ROT,1735,0,4,3190,6,1191.533908,0.037594,0.037594,0.007547
3447,265,263,2,SCHWARZ,1737,0,21,3714,6,1191.571502,0.150943,0.075472,0.007547
3448,263,267,4,ROT,1733,1,36,3618,6,1191.722445,0.730038,0.152091,0.030418
3449,267,266,1,ROT,1734,0,8,3191,6,1192.452483,0.037453,0.037453,0.030418
3450,266,264,2,SCHWARZ,1736,0,21,3716,6,1192.489936,0.150376,0.075188,0.030418
3451,264,260,4,ROT,1740,0,31,3195,6,1192.640312,0.606061,0.151515,0.030418
3452,260,268,8,SCHWARZ,1732,1,26,2561,6,1193.246373,2.953846,0.307692,0.061538
3453,268,269,1,SCHWARZ,1731,1,35,2562,6,1196.200219,0.044776,0.037313,0.007463
3454,269,268,1,SCHWARZ,1732,0,36,3717,6,1196.244995,0.037175,0.037175,0.007463
3455,268,270,2,ROT,1730,1,34,3620,6,1196.282170,0.179104,0.074627,0.014925
3456,270,269,1,ROT,1731,0,11,3196,6,1196.461274,0.037037,0.037037,0.014925
3457,269,267,2,SCHWARZ,1733,0,9,3719,6,1196.498311,0.148699,0.074349,0.014925
3458,267,263,4,ROT,1737,0,28,3200,6,1196.647010,0.599251,0.149813,0.014925
3459,263,271,8,SCHWARZ,1729,1,28,2570,6,1197.246261,2.920152,0.304183,0.060837
3460,271,270,1,SCHWARZ,1730,0,25,3720,6,1200.166413,0.036900,0.036900,0.060837
3461,270,272,2,ROT,1728,1,25,3622,6,1200.203314,0.177778,0.074074,0.014815
3462,272,271,1,ROT,1729,0,26,3201,6,1200.381091,0.036765,0.036765,0.014815
3463,271,273,2,SCHWARZ,1727,1,22,2572,6,1200.417856,0.177122,0.073801,0.014760
3464,273,274,1,SCHWARZ,1726,1,2,2573,6,1200.594978,0.043956,0.036630,0.007326
3465,274,275,1,SCHWARZ,1725,1,13,2574,6,1200.638934,0.043796,0.036496,0.007299
3466,275,274,1,SCHWARZ,1726,0,30,3721,6,1200.682729,0.036364,0.036364,0.007299
3467,274,276,2,ROT,1724,1,36,3624,6,1200.719093,0.175182,0.072993,0.014599
3468,276,275,1,ROT,1725,0,20,3202,6,1200.894276,0.036232,0.036232,0.014599
3469,275,273,2,SCHWARZ,1727,0,12,3723,6,1200.930507,0.145455,0.072727,0.014599
3470,273,277,4,ROT,1723,1,34,3628,6,1201.075962,0.703297,0.146520,0.029304
3471,277,276,1,ROT,1724,0,20,3203,6,1201.779259,0.036101,0.036101,0.029304
3472,276,274,2,SCHWARZ,1726,0,7,3725,6,1201.815360,0.144928,0.072464,0.029304
3473,274,278,4,ROT,1722,1,9,3632,6,1201.960287,0.700730,0.145985,0.029197
3474,278,277,1,ROT,1723,0,31,3204,6,1202.661017,0.035971,0.035971,0.029197
3475,277,279,2,SCHWARZ,1721,1,2,2576,6,1202.696989,0.173285,0.072202,0.014440
3476,279,278,1,SCHWARZ,1722,0,34,3726,6,1202.870274,0.035842,0.035842,0.014440
3477,278,280,2,ROT,1720,1,30,3634,6,1202.906116,0.172662,0.071942,0.014388
3478,280,279,1,ROT,1721,0,2,3205,6,1203.078778,0.035714,0.035714,0.014388
3479,279,281,2,SCHWARZ,1719,1,10,2578,6,1203.114492,0.172043,0.071685,0.014337
3480,281,282,1,SCHWARZ,1718,1,17,2579,6,1203.286535,0.042705,0.035587,0.007117
3481,282,281,1,SCHWARZ,1719,0,25,3727,6,1203.329240,0.035461,0.035461,0.007117
3482,281,279,2,ROT,1721,0,20,3207,6,1203.364701,0.142349,0.071174,0.007117
3483,279,283,4,SCHWARZ,1717,1,4,2583,6,1203.507050,0.688172,0.143369,0.028674
3484,283,284,1,SCHWARZ,1716,1,8,2584,6,1204.195222,0.042403,0.035336,0.007067
3485,284,285,1,SCHWARZ,1715,1,35,2585,6,1204.237624,0.042254,0.035211,0.007042
3486,285,284,1,SCHWARZ,1716,0,27,3728,6,1204.279878,0.035088,0.035088,0.007042
3487,284,282,2,ROT,1718,0,13,3209,6,1204.314966,0.140845,0.070423,0.007042
3488,282,286,4,SCHWARZ,1714,1,15,2589,6,1204.455811,0.680851,0.141844,0.028369
3489,286,285,1,SCHWARZ,1715,0,27,3729,6,1205.136662,0.034965,0.034965,0.028369
3490,285,287,2,ROT,1713,1,34,3636,6,1205.171627,0.168421,0.070175,0.014035
3491,287,288,1,ROT,1712,1,18,3637,6,1205.340048,0.041812,0.034843,0.006969
3492,288,289,1,ROT,1711,1,30,3638,6,1205.381860,0.041667,0.034722,0.006944
3493,289,290,1,ROT,1710,1,16,3639,6,1205.423526,0.041522,0.034602,0.006920
3494,290,289,1,ROT,1711,0,10,3210,6,1205.465049,0.034483,0.034483,0.006920
3495,289,287,2,SCHWARZ,1713,0,16,3731,6,1205.499532,0.138408,0.069204,0.006920
3496,287,283,4,ROT,1717,0,8,3214,6,1205.637940,0.557491,0.139373,0.006920
3497,283,291,8,SCHWARZ,1709,1,29,2597,6,1206.195431,2.713781,0.282686,0.056537
3498,291,290,1,SCHWARZ,1710,0,19,3732,6,1208.909212,0.034364,0.034364,0.056537
3499,290,292,2,ROT,1708,1,25,3641,6,1208.943576,0.165517,0.068966,0.013793
3500,292,293,1,ROT,1707,1,1,3642,6,1209.109094,0.041096,0.034247,0.006849
3501,293,292,1,ROT,1708,0,35,3215,6,1209.150190,0.034130,0.034130,0.006849
3502,292,290,2,SCHWARZ,1710,0,12,3734,6,1209.184319,0.136986,0.068493,0.006849
3503,290,294,4,ROT,1706,1,25,3646,6,1209.321306,0.662069,0.137931,0.027586
3504,294,295,1,ROT,1705,1,5,3647,6,1209.983375,0.040816,0.034014,0.006803
3505,295,294,1,ROT,1706,0,10,3216,6,1210.024191,0.033898,0.033898,0.006803
3506,294,296,2,SCHWARZ,1704,1,13,2599,6,1210.058089,0.163265,0.068027,0.013605
3507,296,295,1,SCHWARZ,1705,0,3,3735,6,1210.221354,0.033784,0.033784,0.013605
3508,295,297,2,ROT,1703,1,16,3649,6,1210.255138,0.162712,0.067797,0.013559
3509,297,298,1,ROT,1702,1,7,3650,6,1210.417850,0.040404,0.033670,0.006734
3510,298,297,1,ROT,1703,0,31,3217,6,1210.458254,0.033557,0.033557,0.006734
3511,297,299,2,SCHWARZ,1701,1,26,2601,6,1210.491811,0.161616,0.067340,0.013468
3512,299,298,1,SCHWARZ,1702,0,32,3736,6,1210.653427,0.033445,0.033445,0.013468
3513,298,296,2,ROT,1704,0,33,3219,6,1210.686872,0.134228,0.067114,0.013468
3514,296,300,4,SCHWARZ,1700,1,2,2605,6,1210.821100,0.648649,0.135135,0.027027
3515,300,299,1,SCHWARZ,1701,0,30,3737,6,1211.469749,0.033333,0.033333,0.027027
3516,299,301,2,ROT,1699,1,1,3652,6,1211.503082,0.160535,0.066890,0.013378
3517,301,302,1,ROT,1698,1,7,3653,6,1211.663617,0.039867,0.033223,0.006645
3518,302,301,1,ROT,1699,0,10,3220,6,1211.703485,0.033113,0.033113,0.006645
3519,301,303,2,SCHWARZ,1697,1,17,2607,6,1211.736597,0.159468,0.066445,0.013289
3520,303,304,1,SCHWARZ,1696,1,13,2608,6,1211.896066,0.039604,0.033003,0.006601
3521,304,305,1,SCHWARZ,1695,1,2,2609,6,1211.935670,0.039474,0.032895,0.006579
3522,305,306,1,SCHWARZ,1694,1,28,2610,6,1211.975143,0.039344,0.032787,0.006557
3523,306,307,1,SCHWARZ,1693,1,35,2611,6,1212.014488,0.039216,0.032680,0.006536
3524,307,308,1,SCHWARZ,1692,1,26,2612,6,1212.053703,0.039088,0.032573,0.006515
3525,308,307,1,SCHWARZ,1693,0,9,3738,6,1212.092791,0.032468,0.032468,0.006515
3526,307,305,2,ROT,1695,0,31,3222,6,1212.125259,0.130293,0.065147,0.006515
3527,305,309,4,SCHWARZ,1691,1,2,2616,6,1212.255552,0.629508,0.131148,0.026230
3528,309,310,1,SCHWARZ,1690,1,10,2617,6,1212.885060,0.038835,0.032362,0.006472
3529,310,311,1,SCHWARZ,1689,1,2,2618,6,1212.923895,0.038710,0.032258,0.006452
3530,311,310,1,SCHWARZ,1690,0,21,3739,6,1212.962605,0.032154,0.032154,0.006452
3531,310,312,2,ROT,1688,1,12,3655,6,1212.994759,0.154839,0.064516,0.012903
3532,312,313,1,ROT,1687,1,7,3656,6,1213.149598,0.038462,0.032051,0.006410
3533,313,312,1,ROT,1688,0,24,3223,6,1213.188059,0.031949,0.031949,0.006410
3534,312,314,2,SCHWARZ,1686,1,31,2620,6,1213.220008,0.153846,0.064103,0.012821
3535,314,315,1,SCHWARZ,1685,1,17,2621,6,1213.373854,0.038217,0.031847,0.006369
3536,315,316,1,SCHWARZ,1684,1,11,2622,6,1213.412071,0.038095,0.031746,0.006349
3537,316,317,1,SCHWARZ,1683,1,31,2623,6,1213.450166,0.037975,0.031646,0.006329
3538,317,318,1,SCHWARZ,1682,1,10,2624,6,1213.488141,0.037855,0.031546,0.006309
3539,318,317,1,SCHWARZ,1683,0,27,3740,6,1213.525996,0.031447,0.031447,0.006309
3540,317,319,2,ROT,1681,1,30,3658,6,1213.557442,0.151420,0.063091,0.012618
3541,319,318,1,ROT,1682,0,2,3224,6,1213.708862,0.031348,0.031348,0.012618
3542,318,316,2,SCHWARZ,1684,0,12,3742,6,1213.740210,0.125786,0.062893,0.012618
3543,316,312,4,ROT,1688,0,26,3228,6,1213.865996,0.506329,0.126582,0.012618
3544,312,320,8,SCHWARZ,1680,1,4,2632,6,1214.372325,2.461538,0.256410,0.051282
3545,320,319,1,SCHWARZ,1681,0,0,3743,6,1216.833863,0.031250,0.031250,0.051282
3546,319,321,2,ROT,1679,1,36,3660,6,1216.865113,0.150470,0.062696,0.012539
3547,321,320,1,ROT,1680,0,20,3229,6,1217.015584,0.031153,0.031153,0.012539
3548,320,322,2,SCHWARZ,1678,1,28,2634,6,1217.046736,0.150000,0.062500,0.012500
3549,322,323,1,SCHWARZ,1677,1,24,2635,6,1217.196736,0.037267,0.031056,0.006211
3550,323,324,1,SCHWARZ,1676,1,35,2636,6,1217.234003,0.037152,0.030960,0.006192
3551,324,325,1,SCHWARZ,1675,1,8,2637,6,1217.271155,0.037037,0.030864,0.006173
3552,325,326,1,SCHWARZ,1674,1,29,2638,6,1217.308192,0.036923,0.030769,0.006154
3553,326,327,1,SCHWARZ,1673,1,20,2639,6,1217.345115,0.036810,0.030675,0.006135
3554,327,328,1,SCHWARZ,1672,1,28,2640,6,1217.381925,0.036697,0.030581,0.006116
3555,328,327,1,SCHWARZ,1673,0,27,3744,6,1217.418622,0.030488,0.030488,0.006116
3556,327,325,2,ROT,1675,0,24,3231,6,1217.449110,0.122324,0.061162,0.006116
3557,325,321,4,SCHWARZ,1679,0,25,3748,6,1217.571434,0.492308,0.123077,0.006116
3558,321,313,8,ROT,1687,0,4,3239,6,1218.063742,1.993769,0.249221,0.006116
3559,313,297,16,SCHWARZ,1703,0,19,3764,6,1220.057511,8.178914,0.511182,0.006116
3560,297,329,32,ROT,1671,1,32,3692,6,1228.236425,41.373737,1.077441,0.215488
3561,329,330,1,ROT,1670,1,34,3693,6,1269.610163,0.036474,0.030395,0.006079
3562,330,331,1,ROT,1669,1,19,3694,6,1269.646637,0.036364,0.030303,0.006061
3563,331,330,1,ROT,1670,0,31,3240,6,1269.683000,0.030211,0.030211,0.006061
3564,330,332,2,SCHWARZ,1668,1,31,2642,6,1269.713212,0.145455,0.060606,0.012121
3565,332,331,1,SCHWARZ,1669,0,9,3765,6,1269.858666,0.030120,0.030120,0.012121
3566,331,329,2,ROT,1671,0,22,3242,6,1269.888787,0.120846,0.060423,0.012121
3567,329,325,4,SCHWARZ,1675,0,12,3769,6,1270.009633,0.486322,0.121581,0.012121
3568,325,333,8,ROT,1667,1,25,3702,6,1270.495955,2.363077,0.246154,0.049231
3569,333,332,1,ROT,1668,0,29,3243,6,1272.859032,0.030030,0.030030,0.049231
3570,332,334,2,SCHWARZ,1666,1,31,2644,6,1272.889062,0.144578,0.060241,0.012048
3571,334,335,1,SCHWARZ,1665,1,15,2645,6,1273.033640,0.035928,0.029940,0.005988
3572,335,334,1,SCHWARZ,1666,0,1,3770,6,1273.069568,0.029851,0.029851,0.005988
3573,334,332,2,ROT,1668,0,33,3245,6,1273.099419,0.119760,0.059880,0.005988
3574,332,336,4,SCHWARZ,1664,1,28,2649,6,1273.219180,0.578313,0.120482,0.024096
3575,336,335,1,SCHWARZ,1665,0,0,3771,6,1273.797493,0.029762,0.029762,0.024096
3576,335,333,2,ROT,1667,0,17,3247,6,1273.827255,0.119403,0.059701,0.024096
3577,333,329,4,SCHWARZ,1671,0,3,3775,6,1273.946658,0.480480,0.120120,0.024096
3578,329,337,8,ROT,1663,1,3,3710,6,1274.427138,2.334347,0.243161,0.048632
3579,337,336,1,ROT,1664,0,35,3248,6,1276.761485,0.029674,0.029674,0.048632
3580,336,338,2,SCHWARZ,1662,1,17,2651,6,1276.791158,0.142857,0.059524,0.011905
3581,338,337,1,SCHWARZ,1663,0,12,3776,6,1276.934016,0.029586,0.029586,0.011905
3582,337,339,2,ROT,1661,1,36,3712,6,1276.963601,0.142433,0.059347,0.011869
3583,339,338,1,ROT,1662,0,22,3249,6,1277.106035,0.029499,0.029499,0.011869
3584,338,336,2,SCHWARZ,1664,0,34,3778,6,1277.135533,0.118343,0.059172,0.011869
3585,336,332,4,ROT,1668,0,0,3253,6,1277.253876,0.476190,0.119048,0.011869
3586,332,324,8,SCHWARZ,1676,0,21,3786,6,1277.730067,1.927711,0.240964,0.011869
3587,324,308,16,ROT,1692,0,6,3269,6,1279.657778,7.901235,0.493827,0.011869
3588,308,276,32,SCHWARZ,1724,0,12,3818,6,1287.559012,33.246753,1.038961,0.011869
3589,276,212,64,ROT,1788,0,22,3333,6,1320.805765,148.405797,2.318841,0.011869
3590,212,213,1,SCHWARZ,1787,1,35,2652,6,1469.211563,0.056604,0.047170,0.009434
3591,213,212,1,SCHWARZ,1788,0,1,3819,6,1469.268166,0.046948,0.046948,0.009434
3592,212,210,2,ROT,1790,0,35,3335,6,1469.315115,0.188679,0.094340,0.009434
3593,210,206,4,SCHWARZ,1794,0,23,3823,6,1469.503794,0.761905,0.190476,0.009434
3594,206,214,8,ROT,1786,1,9,3720,6,1470.265699,3.728155,0.388350,0.077670
3595,214,215,1,ROT,1785,1,34,3721,6,1473.993854,0.056075,0.046729,0.009346
3596,215,216,1,ROT,1784,1,21,3722,6,1474.049929,0.055814,0.046512,0.009302
3597,216,217,1,ROT,1783,1,36,3723,6,1474.105743,0.055556,0.046296,0.009259
3598,217,216,1,ROT,1784,0,31,3336,6,1474.161298,0.046083,0.046083,0.009259
3599,216,214,2,SCHWARZ,1786,0,21,3825,6,1474.207381,0.185185,0.092593,0.009259
3600,214,218,4,ROT,1782,1,32,3727,6,1474.392566,0.897196,0.186916,0.037383
3601,218,217,1,ROT,1783,0,20,3337,6,1475.289763,0.045872,0.045872,0.037383
3602,217,215,2,SCHWARZ,1785,0,12,3827,6,1475.335634,0.184332,0.092166,0.037383
3603,215,219,4,ROT,1781,1,3,3731,6,1475.519966,0.893023,0.186047,0.037209
3604,219,220,1,ROT,1780,1,3,3732,6,1476.412989,0.054795,0.045662,0.009132
3605,220,219,1,ROT,1781,0,29,3338,6,1476.467784,0.045455,0.045455,0.009132
3606,219,221,2,SCHWARZ,1779,1,4,2654,6,1476.513238,0.219178,0.091324,0.018265
3607,221,222,1,SCHWARZ,1778,1,17,2655,6,1476.732416,0.054299,0.045249,0.009050
3608,222,223,1,SCHWARZ,1777,1,22,2656,6,1476.786715,0.054054,0.045045,0.009009
3609,223,222,1,SCHWARZ,1778,0,32,3828,6,1476.840769,0.044843,0.044843,0.009009
3610,222,220,2,ROT,1780,0,11,3340,6,1476.885612,0.180180,0.090090,0.009009
3611,220,216,4,SCHWARZ,1784,0,12,3832,6,1477.065792,0.727273,0.181818,0.009009
3612,216,208,8,ROT,1792,0,15,3348,6,1477.793065,2.962963,0.370370,0.009009
3613,208,192,16,SCHWARZ,1808,0,25,3848,6,1480.756028,12.307692,0.769231,0.009009
3614,192,224,32,ROT,1776,1,30,3764,6,1493.063720,64.000000,1.666667,0.333333
3615,224,223,1,ROT,1777,0,33,3349,6,1557.063721,0.044643,0.044643,0.333333
3616,223,221,2,SCHWARZ,1779,0,12,3850,6,1557.108363,0.179372,0.089686,0.333333
3617,221,225,4,ROT,1775,1,19,3768,6,1557.287736,0.868778,0.180995,0.036199
3618,225,226,1,ROT,1774,1,19,3769,6,1558.156514,0.053333,0.044444,0.008889
3619,226,225,1,ROT,1775,0,22,3350,6,1558.209847,0.044248,0.044248,0.008889
3620,225,223,2,SCHWARZ,1777,0,7,3852,6,1558.254095,0.177778,0.088889,0.008889
3621,223,227,4,ROT,1773,1,25,3773,6,1558.431873,0.860987,0.179372,0.035874
3622,227,226,1,ROT,1774,0,10,3351,6,1559.292859,0.044053,0.044053,0.035874
3623,226,228,2,SCHWARZ,1772,1,35,2658,6,1559.336912,0.212389,0.088496,0.017699
3624,228,227,1,SCHWARZ,1773,0,3,3853,6,1559.549302,0.043860,0.043860,0.017699
3625,227,225,2,ROT,1775,0,29,3353,6,1559.593161,0.176211,0.088106,0.017699
3626,225,221,4,SCHWARZ,1779,0,18,3857,6,1559.769373,0.711111,0.177778,0.017699
3627,221,229,8,ROT,1771,1,3,3781,6,1560.480484,3.475113,0.361991,0.072398
3628,229,228,1,ROT,1772,0,13,3354,6,1563.955597,0.043668,0.043668,0.072398
3629,228,230,2,SCHWARZ,1770,1,4,2660,6,1563.999265,0.210526,0.087719,0.017544
3630,230,229,1,SCHWARZ,1771,0,30,3858,6,1564.209791,0.043478,0.043478,0.017544
3631,229,227,2,ROT,1773,0,8,3356,6,1564.253270,0.174672,0.087336,0.017544
3632,227,231,4,SCHWARZ,1769,1,31,2664,6,1564.427942,0.845815,0.176211,0.035242
3633,231,230,1,SCHWARZ,1770,0,36,3859,6,1565.273757,0.043290,0.043290,0.035242
3634,230,228,2,ROT,1772,0,29,3358,6,1565.317047,0.173913,0.086957,0.035242
3635,228,224,4,SCHWARZ,1776,0,21,3863,6,1565.490960,0.701754,0.175439,0.035242
3636,224,216,8,ROT,1784,0,15,3366,6,1566.192715,2.857143,0.357143,0.035242
3637,216,200,16,SCHWARZ,1800,0,21,3879,6,1569.049857,11.851852,0.740741,0.035242
3638,200,168,32,ROT,1832,0,0,3398,6,1580.901709,51.200000,1.600000,0.035242
3639,168,104,64,SCHWARZ,1896,0,23,3943,6,1632.101709,243.809524,3.809524,0.035242
3640,104,103,1,ROT,1897,0,29,3399,6,1875.911233,0.096154,0.096154,0.035242
3641,103,101,2,SCHWARZ,1899,0,1,3945,6,1876.007387,0.388350,0.194175,0.035242
3642,101,97,4,ROT,1903,0,22,3403,6,1876.395736,1.584158,0.396040,0.035242
3643,97,105,8,SCHWARZ,1895,1,22,2672,6,1877.979895,7.917526,0.824742,0.164948
3644,105,106,1,SCHWARZ,1894,1,8,2673,6,1885.897421,0.114286,0.095238,0.019048
3645,106,105,1,SCHWARZ,1895,0,30,3946,6,1886.011706,0.094340,0.094340,0.019048
3646,105,107,2,ROT,1893,1,1,3783,6,1886.106046,0.457143,0.190476,0.038095
3647,107,106,1,ROT,1894,0,0,3404,6,1886.563189,0.093458,0.093458,0.038095
3648,106,104,2,SCHWARZ,1896,0,36,3948,6,1886.656647,0.377358,0.188679,0.038095
3649,104,108,4,ROT,1892,1,32,3787,6,1887.034005,1.846154,0.384615,0.076923
3650,108,109,1,ROT,1891,1,1,3788,6,1888.880159,0.111111,0.092593,0.018519
3651,109,108,1,ROT,1892,0,31,3405,6,1888.991270,0.091743,0.091743,0.018519
3652,108,106,2,SCHWARZ,1894,0,25,3950,6,1889.083013,0.370370,0.185185,0.018519
3653,106,102,4,ROT,1898,0,31,3409,6,1889.453384,1.509434,0.377358,0.018519
3654,102,94,8,SCHWARZ,1906,0,27,3958,6,1890.962818,6.274510,0.784314,0.018519
3655,94,110,16,ROT,1890,1,9,3804,6,1897.237328,32.680851,1.702128,0.340426
3656,110,109,1,ROT,1891,0,13,3410,6,1929.918179,0.090909,0.090909,0.340426
3657,109,111,2,SCHWARZ,1889,1,29,2675,6,1930.009088,0.440367,0.183486,0.036697
3658,111,110,1,SCHWARZ,1890,0,9,3959,6,1930.449455,0.090090,0.090090,0.036697
3659,110,112,2,ROT,1888,1,32,3806,6,1930.539545,0.436364,0.181818,0.036364
3660,112,113,1,ROT,1887,1,3,3807,6,1930.975908,0.107143,0.089286,0.017857
3661,113,114,1,ROT,1886,1,16,3808,6,1931.083051,0.106195,0.088496,0.017699
3662,114,113,1,ROT,1887,0,28,3411,6,1931.189246,0.087719,0.087719,0.017699
3663,113,111,2,SCHWARZ,1889,0,27,3961,6,1931.276965,0.353982,0.176991,0.017699
3664,111,107,4,ROT,1893,0,8,3415,6,1931.630948,1.441441,0.360360,0.017699
3665,107,99,8,SCHWARZ,1901,0,19,3969,6,1933.072389,5.981308,0.747664,0.017699
3666,99,115,16,ROT,1885,1,9,3824,6,1939.053697,31.030303,1.616162,0.323232
3667,115,114,1,ROT,1886,0,13,3416,6,1970.084001,0.086957,0.086957,0.323232
3668,114,112,2,SCHWARZ,1888,0,0,3971,6,1970.170957,0.350877,0.175439,0.323232
3669,112,116,4,ROT,1884,1,25,3828,6,1970.521834,1.714286,0.357143,0.071429
3670,116,117,1,ROT,1883,1,23,3829,6,1972.236120,0.103448,0.086207,0.017241
3671,117,116,1,ROT,1884,0,11,3417,6,1972.339568,0.085470,0.085470,0.017241
3672,116,118,2,SCHWARZ,1882,1,24,2677,6,1972.425038,0.413793,0.172414,0.034483
3673,118,119,1,SCHWARZ,1881,1,31,2678,6,1972.838831,0.101695,0.084746,0.016949
3674,119,120,1,SCHWARZ,1880,1,6,2679,6,1972.940526,0.100840,0.084034,0.016807
3675,120,119,1,SCHWARZ,1881,0,3,3972,6,1973.041367,0.083333,0.083333,0.016807
3676,119,121,2,ROT,1879,1,27,3831,6,1973.124700,0.403361,0.168067,0.033613
3677,121,120,1,ROT,1880,0,11,3418,6,1973.528061,0.082645,0.082645,0.033613
3678,120,118,2,SCHWARZ,1882,0,9,3974,6,1973.610706,0.333333,0.166667,0.033613
3679,118,122,4,ROT,1878,1,12,3835,6,1973.944039,1.627119,0.338983,0.067797
3680,122,121,1,ROT,1879,0,33,3419,6,1975.571158,0.081967,0.081967,0.067797
3681,121,119,2,SCHWARZ,1881,0,1,3976,6,1975.653125,0.330579,0.165289,0.067797
3682,119,115,4,ROT,1885,0,11,3423,6,1975.983704,1.344538,0.336134,0.067797
3683,115,123,8,SCHWARZ,1877,1,4,2687,6,1977.328242,6.678261,0.695652,0.139130
3684,123,124,1,SCHWARZ,1876,1,35,2688,6,1984.006502,0.097561,0.081301,0.016260
3685,124,125,1,SCHWARZ,1875,1,15,2689,6,1984.104063,0.096774,0.080645,0.016129
3686,125,124,1,SCHWARZ,1876,0,14,3977,6,1984.200838,0.080000,0.080000,0.016129
3687,124,122,2,ROT,1878,0,11,3425,6,1984.280838,0.322581,0.161290,0.016129
3688,122,118,4,SCHWARZ,1882,0,0,3981,6,1984.603418,1.311475,0.327869,0.016129
3689,118,110,8,ROT,1890,0,33,3433,6,1985.914894,5.423729,0.677966,0.016129
3690,110,94,16,SCHWARZ,1906,0,9,3997,6,1991.338622,23.272727,1.454545,0.016129
3691,94,126,32,ROT,1874,1,36,3867,7,14.611350,130.723405,3.404255,0.680851
3692,126,127,1,ROT,1873,1,19,3868,7,145.334754,0.095238,0.079365,0.015873
3693,127,126,1,ROT,1874,0,35,3434,7,145.429992,0.078740,0.078740,0.015873
3694,126,124,2,SCHWARZ,1876,0,1,3999,7,145.508733,0.317460,0.158730,0.015873
3695,124,128,4,ROT,1872,1,16,3872,7,145.826193,1.548387,0.322581,0.064516
3696,128,129,1,ROT,1871,1,19,3873,7,147.374580,0.093750,0.078125,0.015625
3697,129,128,1,ROT,1872,0,15,3435,7,147.468330,0.077519,0.077519,0.015625
3698,128,130,2,SCHWARZ,1870,1,28,2691,7,147.545849,0.375000,0.156250,0.031250
3699,130,131,1,SCHWARZ,1869,1,17,2692,7,147.920849,0.092308,0.076923,0.015385
3700,131,132,1,SCHWARZ,1868,1,13,2693,7,148.013157,0.091603,0.076336,0.015267
3701,132,131,1,SCHWARZ,1869,0,30,4000,7,148.104760,0.075758,0.075758,0.015267
3702,131,133,2,ROT,1867,1,14,3875,7,148.180518,0.366412,0.152672,0.030534
3703,133,134,1,ROT,1866,1,23,3876,7,148.546930,0.090226,0.075188,0.015038
3704,134,135,1,ROT,1865,1,25,3877,7,148.637155,0.089552,0.074627,0.014925
3705,135,136,1,ROT,1864,1,34,3878,7,148.726708,0.088889,0.074074,0.014815
3706,136,137,1,ROT,1863,1,16,3879,7,148.815597,0.088235,0.073529,0.014706
3707,137,136,1,ROT,1864,0,33,3436,7,148.903832,0.072993,0.072993,0.014706
3708,136,134,2,SCHWARZ,1866,0,9,4002,7,148.976825,0.294118,0.147059,0.014706
3709,134,130,4,ROT,1870,0,10,3440,7,149.270942,1.194030,0.298507,0.014706
3710,130,138,8,SCHWARZ,1862,1,22,2701,7,150.464972,5.907692,0.615385,0.123077
3711,138,139,1,SCHWARZ,1861,1,26,2702,7,156.372664,0.086957,0.072464,0.014493
3712,139,138,1,SCHWARZ,1862,0,19,4003,7,156.459621,0.071942,0.071942,0.014493
3713,138,136,2,ROT,1864,0,13,3442,7,156.531563,0.289855,0.144928,0.014493
3714,136,132,4,SCHWARZ,1868,0,9,4007,7,156.821418,1.176471,0.294118,0.014493
3715,132,140,8,ROT,1860,1,36,3887,7,157.997889,5.818182,0.606061,0.121212
3716,140,141,1,ROT,1859,1,23,3888,7,163.816071,0.085714,0.071429,0.014286
3717,141,142,1,ROT,1858,1,5,3889,7,163.901785,0.085106,0.070922,0.014184
3718,142,141,1,ROT,1859,0,24,3443,7,163.986892,0.070423,0.070423,0.014184
3719,141,139,2,SCHWARZ,1861,0,0,4009,7,164.057314,0.283688,0.141844,0.014184
3720,139,143,4,ROT,1857,1,34,3893,7,164.341002,1.381295,0.287770,0.057554
3721,143,142,1,ROT,1858,0,2,3444,7,165.722297,0.069930,0.069930,0.057554
3722,142,144,2,SCHWARZ,1856,1,35,2704,7,165.792227,0.338028,0.140845,0.028169
3723,144,145,1,SCHWARZ,1855,1,35,2705,7,166.130255,0.083333,0.069444,0.013889
3724,145,146,1,SCHWARZ,1854,1,8,2706,7,166.213589,0.082759,0.068966,0.013793
3725,146,147,1,SCHWARZ,1853,1,33,2707,7,166.296347,0.082192,0.068493,0.013699
3726,147,148,1,SCHWARZ,1852,1,2,2708,7,166.378539,0.081633,0.068027,0.013605
3727,148,149,1,SCHWARZ,1851,1,33,2709,7,166.460172,0.081081,0.067568,0.013514
3728,149,150,1,SCHWARZ,1850,1,2,2710,7,166.541253,0.080537,0.067114,0.013423
3729,150,149,1,SCHWARZ,1851,0,0,4010,7,166.621790,0.066667,0.066667,0.013423
3730,149,151,2,ROT,1849,1,9,3895,7,166.688456,0.322148,0.134228,0.026846
3731,151,152,1,ROT,1848,1,12,3896,7,167.010604,0.079470,0.066225,0.013245
3732,152,153,1,ROT,1847,1,21,3897,7,167.090074,0.078947,0.065789,0.013158
3733,153,154,1,ROT,1846,1,1,3898,7,167.169021,0.078431,0.065359,0.013072
3734,154,153,1,ROT,1847,0,17,3445,7,167.247453,0.064935,0.064935,0.013072
3735,153,155,2,SCHWARZ,1845,1,35,2712,7,167.312388,0.313725,0.130719,0.026144
3736,155,154,1,SCHWARZ,1846,0,3,4011,7,167.626113,0.064516,0.064516,0.026144
3737,154,152,2,ROT,1848,0,35,3447,7,167.690630,0.259740,0.129870,0.026144
3738,152,156,4,SCHWARZ,1844,1,15,2716,7,167.950370,1.263158,0.263158,0.052632
3739,156,157,1,SCHWARZ,1843,1,17,2717,7,169.213528,0.076923,0.064103,0.012821
3740,157,156,1,SCHWARZ,1844,0,16,4012,7,169.290451,0.063694,0.063694,0.012821
3741,156,154,2,ROT,1846,0,26,3449,7,169.354145,0.256410,0.128205,0.012821
3742,154,150,4,SCHWARZ,1850,0,25,4016,7,169.610555,1.038961,0.259740,0.012821
3743,150,142,8,ROT,1858,0,26,3457,7,170.649516,4.266667,0.533333,0.012821
3744,142,126,16,SCHWARZ,1874,0,12,4032,7,174.916183,18.028169,1.126761,0.012821
3745,126,94,32,ROT,1906,0,22,3489,7,192.944352,81.269841,2.539683,0.012821
3746,94,30,64,SCHWARZ,1970,0,30,4096,7,274.214193,435.744681,6.808511,0.012821
3747,30,29,1,ROT,1971,0,31,3490,7,709.958874,0.333333,0.333333,0.012821
3748,29,31,2,SCHWARZ,1969,1,35,2719,7,710.292207,1.655172,0.689655,0.137931
3749,31,30,1,SCHWARZ,1970,0,30,4097,7,711.947380,0.322581,0.322581,0.137931
3750,30,32,2,ROT,1968,1,12,3900,7,712.269961,1.600000,0.666667,0.133333
3751,32,33,1,ROT,1967,1,23,3901,7,713.869961,0.375000,0.312500,0.062500
3752,33,34,1,ROT,1966,1,27,3902,7,714.244961,0.363636,0.303030,0.060606
3753,34,33,1,ROT,1967,0,15,3491,7,714.608597,0.294118,0.294118,0.060606
3754,33,31,2,SCHWARZ,1969,0,7,4099,7,714.902715,1.212121,0.606061,0.060606
3755,31,27,4,ROT,1973,0,10,3495,7,716.114836,5.161290,1.290323,0.060606
3756,27,35,8,SCHWARZ,1965,1,11,2727,7,721.276126,28.444445,2.962963,0.592593
3757,35,36,1,SCHWARZ,1964,1,4,2728,7,749.720571,0.342857,0.285714,0.057143
3758,36,35,1,SCHWARZ,1965,0,0,4100,7,750.063428,0.277778,0.277778,0.057143
3759,35,33,2,ROT,1967,0,0,3497,7,750.341206,1.142857,0.571429,0.057143
3760,33,37,4,SCHWARZ,1963,1,2,2732,7,751.484063,5.818182,1.212121,0.242424
3761,37,38,1,SCHWARZ,1962,1,13,2733,7,757.302245,0.324324,0.270270,0.054054
3762,38,37,1,SCHWARZ,1963,0,0,4101,7,757.626569,0.263158,0.263158,0.054054
3763,37,35,2,ROT,1965,0,28,3499,7,757.889727,1.081081,0.540541,0.054054
3764,35,39,4,SCHWARZ,1961,1,29,2737,7,758.970808,5.485714,1.142857,0.228571
3765,39,40,1,SCHWARZ,1960,1,15,2738,7,764.456522,0.307692,0.256410,0.051282
3766,40,41,1,SCHWARZ,1959,1,20,2739,7,764.764214,0.300000,0.250000,0.050000
3767,41,42,1,SCHWARZ,1958,1,28,2740,7,765.064214,0.292683,0.243902,0.048780
3768,42,41,1,SCHWARZ,1959,0,5,4102,7,765.356897,0.238095,0.238095,0.048780
3769,41,43,2,ROT,1957,1,25,3904,7,765.594993,1.170732,0.487805,0.097561
3770,43,42,1,ROT,1958,0,4,3500,7,766.765724,0.232558,0.232558,0.097561
3771,42,44,2,SCHWARZ,1956,1,29,2742,7,766.998282,1.142857,0.476190,0.095238
3772,44,43,1,SCHWARZ,1957,0,0,4103,7,768.141140,0.227273,0.227273,0.095238
3773,43,41,2,ROT,1959,0,11,3502,7,768.368412,0.930233,0.465116,0.095238
3774,41,37,4,SCHWARZ,1963,0,7,4107,7,769.298645,3.902439,0.975610,0.095238
3775,37,45,8,ROT,1955,1,30,3912,7,773.201084,20.756757,2.162162,0.432432
3776,45,46,1,ROT,1954,1,12,3913,7,793.957841,0.266667,0.222222,0.044444
3777,46,47,1,ROT,1953,1,32,3914,7,794.224507,0.260870,0.217391,0.043478
3778,47,46,1,ROT,1954,0,31,3503,7,794.485377,0.212766,0.212766,0.043478
3779,46,48,2,SCHWARZ,1952,1,8,2744,7,794.698143,1.043478,0.434783,0.086957
3780,48,47,1,SCHWARZ,1953,0,30,4108,7,795.741621,0.208333,0.208333,0.086957
3781,47,49,2,ROT,1951,1,3,3916,7,795.949954,1.021277,0.425532,0.085106
3782,49,50,1,ROT,1950,1,30,3917,7,796.971231,0.244898,0.204082,0.040816
3783,50,51,1,ROT,1949,1,5,3918,7,797.216129,0.240000,0.200000,0.040000
3784,51,52,1,ROT,1948,1,34,3919,7,797.456129,0.235294,0.196078,0.039216
3785,52,51,1,ROT,1949,0,26,3504,7,797.691423,0.192308,0.192308,0.039216
3786,51,53,2,SCHWARZ,1947,1,24,2746,7,797.883731,0.941176,0.392157,0.078431
3787,53,54,1,SCHWARZ,1946,1,4,2747,7,798.824907,0.226415,0.188679,0.037736
3788,54,53,1,SCHWARZ,1947,0,19,4109,7,799.051322,0.185185,0.185185,0.037736
3789,53,55,2,ROT,1945,1,7,3921,7,799.236508,0.905660,0.377358,0.075472
3790,55,56,1,ROT,1944,1,14,3922,7,800.142168,0.218182,0.181818,0.036364
3791,56,55,1,ROT,1945,0,13,3505,7,800.360350,0.178571,0.178571,0.036364
3792,55,57,2,SCHWARZ,1943,1,11,2749,7,800.538921,0.872727,0.363636,0.072727
3793,57,56,1,SCHWARZ,1944,0,21,4110,7,801.411649,0.175439,0.175439,0.072727
3794,56,54,2,ROT,1946,0,0,3507,7,801.587087,0.714286,0.357143,0.072727
3795,54,58,4,SCHWARZ,1942,1,6,2753,7,802.301373,3.555556,0.740741,0.148148
3796,58,59,1,SCHWARZ,1941,1,29,2754,7,805.856928,0.206897,0.172414,0.034483
3797,59,58,1,SCHWARZ,1942,0,18,4111,7,806.063825,0.169492,0.169492,0.034483
3798,58,56,2,ROT,1944,0,0,3509,7,806.233316,0.689655,0.344828,0.034483
3799,56,52,4,SCHWARZ,1948,0,23,4115,7,806.922972,2.857143,0.714286,0.034483
3800,52,44,8,ROT,1956,0,29,3517,7,809.780114,12.307692,1.538462,0.034483
3801,44,28,16,SCHWARZ,1972,0,1,4131,7,822.087807,58.181818,3.636364,0.034483
